aaa	Ghotuo
aab	Arum
aac	Ari
aad	Amal
aae	Arbëreshë Albanian
aaf	Aranadan
aag	Ambrak
aah	Abu’
aai	Miniafia Oyan
aak	Ankave
aal	Afade
aan	Anambé
aao	Algerian Saharan Arabic
aap	Pará Arara
aaq	Eastern Abenaki
aar	Afar
aas	Aasáx
aat	Arvanitika Albanian
aau	Abau
aaw	Solong
aax	Mandobo Atas
aaz	Amarasi
aba	Abé
abb	Bankon
abc	Ambala Ayta
abd	Manide
abe	Western Abenaki
abf	Abai Sungai
abg	Wagama
abh	Tajiki Arabic
abi	Abidji
abj	Aka-Bea
abk	Abkhaz
abl	Lampung Nyo
abm	Abanyom
abn	Abua
abo	Abon
abp	Abellen Ayta
abq	Abaza
abr	Abron
abs	Ambonese Malay
abt	Ambulas
abu	Abure
abv	Baharna Arabic
abw	Pal
abx	Inabaknon
aby	Aneme Wake
abz	Abui
aca	Achagua
acb	Áncá
acd	Gikyode
ace	Aceh
acf	Lesser Antillean French Creole
ach	Acholi
aci	Aka-Cari
ack	Aka-Kora
acl	Akar-Bale
acm	Mesopotamian Arabic
acn	Ngochang
acp	Eastern Acipa
acq	Ta’izzi-Adeni Arabic
acr	Achi
acs	Acroá
act	Achterhoeks
acu	Achuar-Shiwiar
acv	Achumawi
acw	Hijazi Arabic
acx	Omani Arabic
acy	Cypriot Arabic
acz	Acheron
ada	Dangme
adb	Atauran
add	Lidzonka
ade	Adele
adf	Dhofari Arabic
adg	Andegerebinha
adh	Jopadhola
adi	Adi
adj	Adioukrou
adl	Galo Adi
adn	Adang
ado	Abu
adq	Adangbe
adr	Adonara
ads	Adamorobe Sign Language
adt	Adnyamathanha
adu	Aduge
adw	Amundava
adx	Amdo Tibetan
ady	Adyghe
adz	Adzera
aea	Areba
aeb	Tunisian Arabic
aec	Sa’idi Arabic
aed	Argentine Sign Language
aee	Northeast Pashai
aek	Haeke
ael	Ambele
aem	Arem
aen	Armenian Sign Language
aeq	Aer
aer	Eastern Arrernte
aes	Alsea
aeu	Akeu
aew	Ambakich
aey	Amele
aez	Aeka
afb	Gulf Arabic
afd	Andai
afe	Utugwang-Irungene-Afrike
afg	Afghan Sign Language
afi	Chini
afk	Nanubae
afn	Defaka
afo	Ajiri
afp	Tapei
afr	Afrikaans
afs	Afro-Seminole Creole
aft	Afitti
afu	Awutu
afz	Obokuitai
aga	Aguano
agb	Legbo
agc	Agatu
agd	Agarabi
age	Angal
agf	Arguni
agg	Angor
agh	Ngelima
agi	Agariya
agj	Argobba
agk	Katubung Agta
agl	Fembe
agm	Angaataha
agn	Agutaynen
ago	Tainae
agq	Aghem
agr	Awajún
ags	Esimbi
agt	Central Cagayan Agta
agu	Awakateko
agv	Remontado Dumagat
agw	Kahua
agx	Aghul
agy	Southern Alta
agz	Mt. Iriga Agta
aha	Ahanta
ahb	Axamb
ahg	Qimant
ahh	Aghu
ahi	Tiagbamrin Aizi
ahk	Akha
ahl	Igo
ahm	Mobumrin Aizi
ahn	Àhàn
aho	Ahom
ahp	Aproumu Aizi
ahr	Ahirani
ahs	Ashe
aht	Ahtena
aia	Arosi
aib	Ainu
aic	Ainbai
aid	Alngith
aie	Amara
aif	Agi
aig	Leeward Caribbean English Creole
aih	Ai-Cham
aii	Assyrian Neo-Aramaic
aij	Inter-Zab Jewish Neo-Aramaic
aik	Akye
ail	Eibela
aim	Aimol
ain	Ainu
aio	Aiton
aip	Burumakok
aiq	Aimaq
air	Airoran
ait	Arikem
aiw	Aari
aix	Aighon
aiy	Ali
aja	Aja
ajg	Aja
aji	Ajië
ajn	Andajin
ajs	Algerian Jewish Sign Language
aju	Judeo-Moroccan Arabic
ajw	Ajawa
ajz	Amri Karbi
aka	Akan
akb	Batak Angkola
akc	Mpur
akd	Ukpet-Ehom
ake	Akawaio
akf	Akweya
akg	Anakalangu
akh	Angal Heneng
aki	Aiome
akj	Aka-Jeru
akl	Aklanon
akm	Aka-Bo
ako	Akurio
akp	Siwu
akq	Ak
akr	Soro-n Raki
aks	Akaselem
akt	Akolet
aku	Akum
akv	Akhvakh
akw	Akwa
akx	Aka-Kede
aky	Aka-Kol
akz	Alabama
ala	Alago
alc	Qawasqar
ald	Alladian
ale	Aleut
alf	Elege
alh	Alawa
ali	Amaimon
alj	Alangan
alk	Alak
all	Allar
alm	Amblong
aln	Gheg Albanian
alo	Larike-Wakasihu
alp	Alune
alq	Algonquin
alr	Alutor
als	Tosk Albanian
alt	Southern Altai
alu	’Are’are
alw	Alaba-K’abeena
alx	Mol
aly	Alyawarr
alz	Alur
ama	Amanayé
amb	Ambo
amc	Amahuaca
ame	Yanesha’
amf	Hamer-Banna
amg	Amurdak
amh	Amharic
ami	Amis
amj	Amdang
amk	Ambai
aml	War-Jaintia
amm	Sawiyanu
amn	Amanab
amo	Amo
amp	Alamblak
amq	Amahai
amr	Amarakaeri
ams	Southern Amami-Oshima
amt	Amto
amu	Guerrero Amuzgo
amv	Ambelau
amw	Western Neo-Aramaic
amx	Anmatyerr
amy	Ami
amz	Atampaya
ana	Andaqui
anb	Andoa
anc	Ngas
and	Ansus
ane	Xârâcùù
anf	Animere
anh	Nend
ani	Andi
anj	Anor
ank	Goemai
anl	Anu-Khongso Chin
anm	Anal
ann	Obolo
ano	Andoque
anp	Angika
anq	Jarawa
anr	Andh
ans	Anserma
ant	Antikarinya
anu	Anuak
anv	Denya
anw	Anaang
anx	Andra-Hus
any	Anyin
anz	Anem
aoa	Angolar
aob	Abom
aoc	Pemon
aod	Andarum
aoe	Angal Enen
aof	Bragat
aog	Angoram
aoi	Anindilyakwa
aoj	Mufian
aok	Arhö
aol	Alor
aom	Ömie
aon	Weri
aor	Aore
aos	Taikat
aot	Atong
aou	A’ou
aox	Atorada
aoz	Uab Meto
apb	Saꞌa
apc	Levantine Arabic
apd	Sudanese Arabic
ape	Bukiyip
apf	Pahanan Agta
apg	Ampanang
aph	Athpariya
api	Apiaká
apj	Jicarilla Apache
apk	Kiowa Apache
apl	Lipan Apache
apm	Mescalero-Chiricahua Apache
apn	Apinagé
apo	Ambul
app	Apma
apq	A-Pucikwar
apr	Arop-Lokep
aps	Orop
apt	Apatani
apu	Apurinã
apv	Alapmunte
apw	Western Apache
apx	Aputai
apy	Apalaí
apz	Safeyoka
aqc	Archi
aqd	Ampari Dogon
aqg	Arigidi
aqk	Aninka
aqm	Atohwaim
aqn	Northern Alta
aqp	Atakapa
aqr	Arhâ
aqt	Angaité
aqz	Akuntsu
arb	Standard Arabic
ard	Arabana
are	Western Arrarnta
arg	Aragonese
arh	Arhuaco
ari	Arikara
arj	Arapaso
ark	Arikapú
arl	Arabela
arn	Mapudungun
aro	Araona
arp	Arapaho
arq	Algerian Arabic
arr	Karo
ars	Najdi Arabic
aru	Aruá
arv	Arbore
arw	Arawak
arx	Aruá
ary	Moroccan Arabic
arz	Egyptian Arabic
asa	Asu
asb	Assiniboine
asc	Casuarina Coast Asmat
ase	American Sign Language
asf	Auslan
asg	Cishingini
ash	Awishira
asi	Buruwai
asj	Sari
ask	Ashkun
asl	Asilulu
asm	Assamese
asn	Asurini of Xingú
aso	Dano
asp	Algerian Sign Language
asq	Austrian Sign Language
asr	Asuri
ass	Ipulo
ast	Asturian
asu	Tocantins Asurini
asv	Asoa
asw	Australian Aborigines Sign Language
asx	Muratayak
asy	Yaosakor Asmat
asz	As
ata	Pele-Ata
atb	Zaiwa
atc	Atsahuaca
atd	Ata Manobo
ate	Mand
atg	Ivbie North-Okpela-Arhe
ati	Attié
atj	Atikamekw
atk	Ati
atl	Mt. Iraya Agta
atm	Ata
atn	Ashtiani
ato	Atong
atp	Pudtol Atta
atq	Aralle-Tabulahan
atr	Waimiri-Atroarí
ats	Gros Ventre
att	Pamplona Atta
atu	Reel
atv	Northern Altai
atw	Atsugewi
atx	Arutani
aty	Aneityum
atz	Arta
aua	Asumboa
aub	Alugu
auc	Waorani
aud	Anuta
aug	Aguna
auh	Aushi
aui	Anuki
auj	Awjilah
auk	Heiyoho
aul	Aulua
aum	Asu
aun	Molmo One
auo	Auyokawa
aup	Makayam
auq	Anus
aur	Aruek
aut	Austral
auu	Auye
auw	Awyi
aux	Aurá
auy	Awiyaana
auz	Uzbeki Arabic
ava	Avar
avb	Avau
avd	Alviri-Vidari
ave	Avestan
avi	Avikam
avl	Levantine Bedawi Arabic
avm	Angkamuthi
avn	Avatime
avo	Agavotaguerra
avs	Aushiri
avt	Au
avu	Avokaya
avv	Avá-Canoeiro
awa	Avadhi
awb	Awa
awc	Cicipu
awe	Awetí
awg	Anguthimri
awh	Awbono
awi	Aekyom
awk	Awabakal
awm	Taupi
awn	Awngi
awo	Awak
awr	Awera
aws	South Awyu
awt	Araweté
awu	Central Awyu
awv	Jair Awyu
aww	Awun
awx	Awara
awy	Edera Awyu
axb	Abipon
axe	Ayerrerenge
axg	Mato Grosso Arára
axk	Aka
axl	Lower Southern Aranda
axx	Xârâgurè
aya	Awar
ayb	Ayizo Gbe
ayc	Southern Aymara
ayd	Ayabadhu
aye	Ayere
ayg	Ginyanga
ayh	Hadrami Arabic
ayi	Leyigha
ayk	Akuku
ayl	Libyan Arabic
ayn	Sanaani Arabic
ayo	Ayoreo
ayp	North Mesopotamian Arabic
ayq	Ayi
ayr	Central Aymara
ays	Sorsogon Ayta
ayt	Magbukun Ayta
ayu	Ayu
ayz	Mai Brat
aza	Azha
azb	South Azerbaijani
azd	Eastern Durango Nahuatl
azg	San Pedro Amuzgos Amuzgo
azj	North Azerbaijani
azm	Ipalapa Amuzgo
azn	Western Durango Nahuatl
azo	Awing
azt	Faire Atta
azz	Highland Puebla Nahuatl
baa	Babatana
bab	Bainouk-Gunyuño
bac	Badui
bae	Baré
baf	Nubaca
bag	Tuki
bah	Bahamas English Creole
baj	Barakai
bak	Bashkort
bam	Bamanankan
ban	Bali
bao	Waimaha
bap	Bantawa
bar	Bavarian
bas	Basaa
bau	Mbat
bav	Vengo
baw	Bambili-Bambui
bax	Bamun
bay	Gwatlelir
bba	Baatonum
bbb	Barai
bbc	Batak Toba
bbd	Fulumu
bbe	Bangba
bbf	Baibai
bbg	Barama
bbh	Bugan
bbi	Barombi
bbj	Ghomálá’
bbk	Babanki
bbl	Bats
bbm	Babango
bbn	Uneapa
bbo	Konabéré
bbp	West Central Banda
bbq	Chopechop
bbr	Girawa
bbs	Iyongiyong
bbt	Burku
bbu	Kulung
bbv	Karnai
bbw	Supapya
bbx	Bubia
bby	Befang
bca	Central Bai
bcb	Bainouk-Samik
bcc	Southern Balochi
bcd	North Babar
bce	Mengambo
bcf	Bamu
bcg	Baga Pokur
bch	Bariai
bci	Baoulé
bcj	Bardi
bck	Bunuba
bcl	Central Bikol
bcm	Bannoni
bcn	Bali
bco	Kaluli
bcp	Bali
bcq	Bench
bcr	Babine
bcs	Hohumono
bct	Bendi
bcu	Awad Bing
bcv	Shoo-Minda-Nye
bcw	Bana
bcy	Bacama
bcz	Bainouk-Gunyaamolo
bda	Bayot
bdb	Basap
bdc	Embera Baudó
bdd	Bunama
bde	Bade
bdf	Biage
bdg	Bonggi
bdh	Baka
bdi	Burun
bdj	Bai
bdk	Budukh
bdl	Indonesian Bajau
bdm	Buduma
bdn	Baldemu
bdo	Morom
bdp	Bende
bdq	Bahnar
bdr	West Coast Bajau
bds	Burunge
bdt	Bhogoto
bdu	Oroko
bdv	Bodo Parja
bdw	Baham
bdx	Budong-Budong
bdy	Bandjalang
bdz	Badeshi
bea	Beaver
beb	Bebele
bec	Iceve-Maci
bed	Bedoanas
bee	Byangsi
bef	Benabena
beg	Belait
beh	Biali
bei	Bakati’
bej	Bedawiyet
bek	Bebeli
bel	Belarusian
bem	Bemba
ben	Bengali
beo	Bedamuni
bep	Behoa
beq	Beembe
bes	Besme
bet	Guiberoua Bété
beu	Blagar
bev	Daloa Bété
bew	Betawi
bex	Jur Modo
bey	Beli
bez	Bena
bfa	Bari
bfb	Pauri Bareli
bfc	Panyi Bai
bfd	Bafut
bfe	Betaf
bff	Bofi
bfg	Busang Kayan
bfh	Blafe
bfi	British Sign Language
bfj	Chufie’
bfk	Ban Khor Sign Language
bfl	Banda-Ndélé
bfm	Mmen
bfn	Bunak
bfo	Malba Birifor
bfp	Beba
bfq	Badaga
bfr	Bazigar
bfs	Southern Bai
bft	Balti
bfu	Gahri
bfw	Bondo
bfx	Bantayanon
bfy	Bagheli
bfz	Mahasu Pahari
bga	Gwamhi-Wuri
bgb	Bobongko
bgc	Haryanvi
bgd	Rathwi Bareli
bge	Bauria
bgf	Bangandu
bgg	Bugun
bgi	Bagobo-Klata
bgj	Mendenkye
bgk	Bit
bgl	Bo
bgn	Western Balochi
bgo	Baga Koga
bgp	Eastern Balochi
bgq	Bagri
bgr	Bawm Chin
bgs	Tagabawa
bgt	Bughotu
bgu	Mbongno
bgv	Warkay-Bipim
bgw	Bhatri
bgx	Balkan Gagauz Turkish
bgy	Benggoi
bgz	Banggai
bha	Bharia
bhb	Bhili
bhc	Biga
bhd	Bhadrawahi
bhe	Bhaya
bhf	Odiai
bhg	Binandere
bhh	Bukharic
bhi	Bhilali
bhj	Bahing
bhl	Bimin
bhm	Bathari
bhn	Bohtan Neo-Aramaic
bho	Bhojpuri
bhp	Bima
bhq	Tukang Besi South
bhr	Bara Malagasy
bhs	Buwal
bht	Bhattiyali
bhu	Bhunjia
bhv	Bahau
bhw	Biak
bhx	Bhalay
bhy	Bhele
bhz	Bada
bia	Badimaya
bib	Bissa
bid	Bidiyo
bie	Bepour
bif	Biafada
big	Biangai
bil	Bille
bim	Bimoba
bin	Edo
bio	Nai
bip	Bila
biq	Bipi
bir	Bisorio
bis	Bislama
bit	Berinomo
biu	Biate
biv	Southern Birifor
biw	Kol
bix	Bijori
biy	Birhor
biz	Baloi
bja	Budja
bjb	Barngarla
bjc	Bariji
bje	Biao-Jiao Mien
bjf	Barzani-Sandu Jewish Neo-Aramaic
bjg	Bijagó
bjh	Bahinemo
bji	Burji
bjj	Kanauji
bjk	Barok
bjl	Bulu
bjm	Bajelani
bjn	Banjar
bjo	Mid-Southern Banda
bjp	Fanamaket
bjr	Binumarien
bjs	Bajan
bjt	Balanta-Ganja
bju	Busuu
bjv	Bedjond
bjw	Bakwé
bjx	Vanaw Kalinga
bjy	Bayali
bjz	Baruga
bka	Kyak
bkc	Baka
bkd	Binukid
bkf	Beeke
bkg	Buraka
bkh	Bakoko
bki	Baki
bkj	Pande
bkk	Brokskat
bkl	Berik
bkm	Kom
bkn	Bukitan
bko	Kwa’
bkp	Boko
bkq	Bakairí
bkr	Bakumpai
bks	Northern Sorsoganon
bkt	Boloki
bku	Buhid
bkv	Bekwarra
bkw	Bekwel
bkx	Baikeno
bky	Bokyi
bkz	Bungku
bla	Blackfoot
blb	Bilua
blc	Bella Coola
bld	Bolango
ble	Balanta
blf	Buol
blh	Kuwaa
bli	Bolia
blj	Bulungan
blk	Pa’o
bll	Biloxi
blm	Beli
bln	Southern Catanduanes Bikol
blo	Anii
blp	Blablanga
blq	Paluai
blr	Blang
bls	Balaesang
blt	Tai Dam
blv	Kibala
blw	Balangao
blx	Mag-Indi Ayta
bly	Notre
blz	Balantak
bma	Lame
bmb	Bembe
bmc	Biem
bmd	Baga Manduri
bme	Limassa
bmf	Bom-Kim
bmg	Bamwe
bmh	Kein
bmi	Bagirmi
bmj	Bote
bmk	Ghayavi
bml	Bomboli
bmm	Northern Betsimisaraka Malagasy
bmn	Bina
bmo	Chrambo
bmp	Gamane
bmq	Bomu
bmr	Muinane
bms	Bilma Kanuri
bmt	Biao Mon
bmu	Somba-Siawari
bmv	Bum
bmw	Bomwali
bmx	Baimak
bmz	Baramu
bna	Bonerate
bnb	Bookan Murut
bnd	Banda
bne	Bintauna
bnf	Masiwang
bng	Benga
bni	Bobangi
bnj	Bangon
bnk	Bierebo
bnl	Boon
bnm	Bapuku
bnn	Bunun
bno	Bantoanon
bnp	Bola
bnq	Bantik
bnr	Butmas-Tur
bns	Bundeli
bnu	Bentong
bnv	Beneraf
bnw	Bisis
bnx	Bangubangu
bny	Vaie
bnz	Beezen
boa	Bora
bob	Aweer
bod	Tibetan
boe	Mundabli
bof	Bolon
bog	Malian Sign Language
boh	Boma
boi	Barbareño
boj	Anjam
bok	Bonjo
bol	Bole
bom	Berom
bon	Bine
boo	Tiemacèwè Bozo
bop	Bonkiman
boq	Bogaya
bor	Borôro
bos	Bosnian
bot	Bongo
bou	Bondei
bov	Tuwuli
bow	Rema
box	Buamu
boy	Bodo
boz	Tieyaxo Bozo
bpa	Daakaka
bpc	Mbuk
bpd	Banda-Banda
bpe	Bauni
bpg	Bonggo
bph	Botlikh
bpi	Bagupi
bpj	Bindji
bpk	Orowe
bpl	Broome Pearling Lugger Pidgin
bpm	Biyom
bpn	Dzao Min
bpo	Anasi
bpp	Kaure
bpq	Banda Malay
bpr	Koronadal Blaan
bps	Sarangani Blaan
bpt	Barrow Point
bpu	Bongu
bpv	Bian Marind
bpw	Bo
bpx	Palya Bareli
bpy	Bishnupuriya
bpz	Bilba
bqa	Tchumbuli
bqb	Bagusa
bqc	Boko
bqd	Bung
bqf	Baga Kaloum
bqg	Bago-Kusuntu
bqh	Baima
bqi	Bakhtiâri
bqj	Bandial
bqk	Banda-Mbrès
bql	Karian
bqm	Wumboko
bqn	Bulgarian Sign Language
bqo	Balo
bqp	Bisã
bqq	Biritai
bqr	Burusu
bqs	Bosmun
bqt	Mankong
bqu	Boguru
bqv	Koro Wachi
bqw	Buru
bqx	Baangi
bqy	Kata Kolok
bqz	Bakaka
bra	Braj Bhasha
brb	Brao
brc	Berbice Dutch Creole
brd	Baram
bre	Breton
brf	Bira
brg	Baure
brh	Brahui
bri	Mokpwe
brj	Bieria
brk	Birked
brl	Birwa
brm	Barambu
brn	Boruca
bro	Brokkat
brp	Barapasi
brq	Breri
brr	Birao
brs	Baras
brt	Bitare
bru	Eastern Bru
brv	Western Bru
brw	Bellari
brx	Boro
bry	Burui
brz	Bilbil
bsa	Abinomn
bsb	Brunei Bisaya
bsc	Oniyan
bse	Wushi
bsf	Bauchi
bsg	Bashkardi
bsh	Kateviri
bsi	Bassossi
bsj	Bangwinji
bsk	Burushaski
bsl	Basa-Gumna
bsm	Busami
bsn	Barasana-Eduria
bso	Buso
bsp	Baga Sitemu
bsq	Bassa
bsr	Bassa-Kontagora
bss	Akoose
bst	Basketo
bsu	Bahonsuai
bsv	Baga Sobané
bsw	Baiso
bsx	Yangkam
bsy	Sabah Bisaya
bta	Bata
btc	Bati
btd	Batak Dairi
bte	Gamo-Ningi
btf	Birgit
btg	Gagnoa Bété
bth	Biatah Bidayuh
bti	Burate
btj	Bacanese Malay
btm	Batak Mandailing
btn	Ratagnon
bto	Rinconada Bikol
btp	Budibud
btq	Batek
btr	Baetora
bts	Batak Simalungun
btt	Bete-Bendi
btu	Batu
btv	Bateri
btw	Butuanon
btx	Batak Karo
bty	Bobot
btz	Batak Alas-Kluet
bub	Bua
buc	Bushi
bud	Ntcham
bue	Beothuk
buf	Bushoong
bug	Bugis
buh	Younuo Bunu
bui	Bongili
buj	Basa-Gurmana
buk	Bugawac
bul	Bulgarian
bum	Bulu
bun	Sherbro
buo	Terei
bup	Busoa
buq	Brem
bus	Bokobaru
but	Bungain
buu	Budu
buv	Bun
buw	Bubi
bux	Boghom
buy	Bullom So
buz	Bukwen
bva	Barein
bvb	Bube
bvc	Baelelea
bvd	Baeggu
bve	Berau Malay
bvf	Boor
bvg	Bonkeng
bvh	Bure
bvi	Belanda Viri
bvj	Baan
bvk	Bukat
bvl	Bolivian Sign Language
bvm	Ngiemekohke
bvn	Buna
bvo	Bolgo
bvp	Bumang
bvq	Birri
bvr	Burarra
bvt	Bati
bvu	Bukit Malay
bvv	Baniva
bvw	Boga
bvx	Dibole
bvy	Baybayanon
bvz	Bauzi
bwa	Bwatoo
bwb	Namosi-Naitasiri-Serua
bwc	Bwile
bwd	Bwaidoka
bwe	Bwe Karen
bwf	Boselewa
bwg	Barwe
bwh	Bishuo
bwi	Baniwa
bwj	Láá Láá Bwamu
bwk	Bauwaki
bwl	Bwela
bwm	Biwat
bwn	Wunai Bunu
bwo	Borna
bwp	Mandobo Bawah
bwq	Southern Bobo Madaré
bwr	Bura-Pabir
bws	Bomboma
bwt	Bafaw-Balong
bwu	Buli
bww	Bwa
bwx	Bu-Nao Bunu
bwy	Cwi Bwamu
bwz	Bwisi
bxa	Bauro
bxb	Belanda Bor
bxc	Molengue
bxd	Pela
bxe	Ongota
bxf	Minigir
bxg	Bangala
bxh	Buhutu
bxi	Pirlatapa
bxj	Bayungu
bxk	Bukusu
bxl	Jalkunan
bxm	Mongolia Buriat
bxn	Burduna
bxo	Barikanchi
bxp	Bebil
bxq	Beele
bxr	Russia Buriat
bxs	Busam
bxu	China Buriat
bxv	Berakou
bxw	Bankagooma
bxz	Binahari
bya	Batak
byb	Bikya
byc	Ubaghara
byd	Benyadu’
bye	Pouye
byf	Bete
byg	Baygo
byh	Bhujel
byi	Buyu
byj	Bina
byk	Biao
byl	Bayono
bym	Bidjara
byn	Bilen
byo	Biyo
byp	Bumaji
byq	Basay
byr	Yipma
bys	Burak
byt	Berti
byv	Medumba
byw	Belhariya
byx	Qaqet
byz	Waran
bza	Bandi
bzb	Andio
bzc	Southern Betsimisaraka Malagasy
bzd	Bribri
bze	Jenaama Bozo
bzf	Boikin
bzg	Babuza
bzh	Central Buang
bzi	Bisu
bzj	Belize English Creole
bzk	Nicaragua English Creole
bzl	Boano
bzm	Bolondo
bzn	Boano
bzo	Bozaba
bzp	Kemberano
bzq	Buli
bzr	Biri
bzs	Brazilian Sign Language
bzu	Burmeso
bzv	Naami
bzw	Basa
bzx	Kelengaxo Bozo
bzy	Abanglekuo
bzz	Evant
caa	Ch’orti’
cab	Garifuna
cac	Chuj
cad	Caddo
cae	Laalaa
caf	Southern Carrier
cag	Nivaclé
cah	Cahuarano
caj	Chané
cak	Kaqchikel
cal	Carolinian
cam	Cemuhî
can	Chambri
cao	Chácobo
cap	Chipaya
caq	Car Nicobarese
car	Carib
cas	Tsimané
cat	Catalan
cav	Cavineña
caw	Callawalla
cax	Chiquitano
cay	Cayuga
caz	Canichana
cbb	Cabiyarí
cbc	Carapana
cbd	Carijona
cbg	Chimila
cbi	Chachi
cbj	Ede Cabe
cbk	Chavacano
cbl	Bualkhaw Chin
cbn	Nyahkur
cbo	Izora
cbq	Tsucuba
cbr	Kakataibo-Kashibo
cbs	Kashinawa
cbt	Shawi
cbu	Kandozi-Chapra
cbv	Cacua
cbw	Kinabalian
cby	Carabayo
ccc	Chamicuro
ccd	Cafundo Creole
cce	Chopi
ccg	Samba Daka
cch	Atsam
ccj	Kasanga
ccl	Cutchi-Swahili
ccm	Malaccan Malay Creole
cco	Comaltepec Chinantec
ccp	Chakma
ccr	Cacaopera
cda	Choni
cde	Chenchu
cdf	Chiru
cdh	Chambeali
cdi	Chodri
cdj	Churahi
cdm	Chepang
cdn	Chaudangsi
cdo	Min Dong Chinese
cdr	Kamuku
cds	Chadian Sign Language
cdy	Chadong
cdz	Koda
cea	Lower Chehalis
ceb	Cebuano
ceg	Chamacoco
cek	Eastern Khumi Chin
cen	Ibaas
ces	Czech
cet	Centúúm
cey	Läoktü Chin
cfa	Cham
cfd	Cara
cfg	Karimjo
cfm	Falam Chin
cga	Changriwa
cgc	Kagayanen
cgg	Chiga
cgk	Chocangacakha
cha	Chamorro
chb	Chibcha
chc	Catawba
chd	Highland Oaxaca Chontal
che	Chechen
chf	Tabasco Chontal
chg	Chagatai
chh	Chinook
chj	Ojitlán Chinantec
chk	Chuukese
chl	Cahuilla
chn	Chinook Wawa
cho	Choctaw
chp	Dene
chq	Quiotepec Chinantec
chr	Cherokee
cht	Cholón
chu	Church Slavonic
chv	Chuvash
chw	Chuwabu
chx	Chantyal
chy	Cheyenne
chz	Ozumacín Chinantec
cia	Cia-Cia
cib	Ci Gbe
cic	Chickasaw
cid	Chimariko
cie	Cineni
cih	Chinali
cik	Chitkuli Kinnauri
cim	Cimbrian
cin	Cinta Larga
cip	Chiapanec
cir	Tîrî
ciw	Chippewa
ciy	Chaima
cja	Western Cham
cje	Chru
cjh	Upper Chehalis
cji	Chamalal
cjk	Chokwe
cjm	Eastern Cham
cjn	Chenapian
cjo	Pajonal Ashéninka
cjp	Cabécar
cjs	Shor
cjv	Chuave
cjy	Jinyu Chinese
ckb	Central Kurdish
ckh	Chak
ckl	Kibaku
ckm	Chakavian
ckn	Kaang Chin
cko	Anufo
ckq	Kajakse
ckr	Kairak
cks	Tayo
ckt	Chukchi
cku	Koasati
ckv	Kavalan
ckx	Caka
cky	Cakfem-Mushere
ckz	Kaqchikel-K’iche’ Mixed Language
cla	Ron
clc	Chilcotin
cld	Chaldean Neo-Aramaic
cle	Lealao Chinantec
clh	Chilisso
cli	Chakali
clj	Laitu Chin
clk	Idu-Mishmi
cll	Chala
clm	Clallam
clo	Lowland Oaxaca Chontal
clt	Lautu Chin
clu	Caluyanun
clw	Chulym
cly	Eastern Highland Chatino
cma	Maa
cme	Cerma
cmi	Embera Chamí
cml	Koneq-koneq
cmm	Michigamea
cmn	Mandarin Chinese
cmo	Central Mnong
cmr	Mro-Khimi
cmt	Camtho
cna	Changthang
cnb	Uppu Chin
cnc	Côông
cng	Northern Qiang
cnh	Hakha Chin
cni	Asháninka
cnk	Khumi Chin
cnl	Lalana Chinantec
cno	Con
cnp	Northern Pinghua
cnq	Chung
cnr	Montenegrin
cns	Central Asmat
cnt	Tepetotutla Chinantec
cnu	Chenoua
cnw	Ngawn Chin
coa	Cocos Islands Malay
cob	Chicomuceltec
coc	Cocopa
cod	Kukama-Kukamiria
coe	Koreguaje
cof	Tsafiki
cog	Chong
coh	Chichonyi-Chidzihana-Chikauma
coj	Cochimi
cok	Santa Teresa Cora
col	Columbia-Wenatchi
com	Comanche
con	Cofán
coo	Comox
cop	Coptic
coq	Coquille
cor	Cornish
cos	Corsican
cot	Caquinte
cou	Wamey
cov	Cao Miao
cow	Cowlitz
cox	Nanti
coz	Chocholtec
cpa	Palantla Chinantec
cpb	Ucayali-Yurúa Ashéninka
cpc	Ajyíninka Apurucayali
cpg	Cappadocian Greek
cpi	Chinese Pidgin English
cpn	Cherepon
cpo	Kpeego
cps	Capiznon
cpu	Pichis Ashéninka
cpx	Pu-Xian Chinese
cpy	South Ucayali Ashéninka
cqd	Chuanqiandian Cluster Miao
cra	Tsaara
crb	Island Carib
crc	Lonwolwol
crd	Coeur d’Alene
crf	Caramanta
crg	Michif
crh	Crimean Tatar
cri	Sãotomense
crj	Southern East Cree
crk	Plains Cree
crl	Northern East Cree
crm	Moose Cree
crn	El Nayar Cora
cro	Crow
crq	Manjui
crr	Carolina Algonquian
crs	Seychelles French Creole
crt	Iyojwa’ja Chorote
crv	Chaura
crw	Chrau
crx	Carrier
cry	Kyoli
crz	Cruzeño
csa	Chiltepec Chinantec
csb	Kashubian
csc	Catalan Sign Language
csd	Chiangmai Sign Language
cse	Czech Sign Language
csf	Cuban Sign Language
csg	Chilean Sign Language
csh	Asho Chin
csi	Coast Miwok
csj	Songlai Chin
csk	Jola-Kasa
csl	Chinese Sign Language
csm	Central Sierra Miwok
csn	Colombian Sign Language
cso	Sochiapam Chinantec
csp	Southern Pinghua
csq	Croatian Sign Language
csr	Costa Rican Sign Language
css	Southern Ohlone
cst	Northern Ohlone
csv	Sumtu Chin
csw	Swampy Cree
csx	Cambodian Sign Language
csy	Siyin Chin
csz	Coos
cta	Tataltepec Chatino
ctc	Chetco
ctd	Tedim Chin
cte	Tepinapa Chinantec
ctg	Chittagonian
cth	Thaiphum Chin
ctl	Tlacoatzintepec Chinantec
ctm	Chitimacha
ctn	Chhintang
cto	Emberá-Catío
ctp	Western Highland Chatino
cts	Northern Catanduanes Bikol
ctt	Wayanad Chetti
ctu	Chol
cty	Moundadan Chetti
ctz	Zacatepec Chatino
cua	Cua
cub	Cubeo
cuc	Usila Chinantec
cuh	Gichuka
cui	Cuiba
cuj	Mashco Piro
cuk	San Blas Kuna
cul	Culina
cuo	Cumanagoto
cup	Cupeño
cuq	Cun
cur	Chhiling
cut	Teutila Cuicatec
cuu	Tai Ya
cuv	Cuvok
cuw	Chukwa
cux	Tepeuxila Cuicatec
cuy	Cuitlatec
cvg	Chug
cvn	Valle Nacional Chinantec
cwa	Kabwa
cwb	Maindo
cwd	Woods Cree
cwe	Kwere
cwg	Cheq Wong
cwt	Kuwaataay
cxh	Cha’ari
cya	Nopala Chatino
cyb	Cayubaba
cym	Welsh
cyo	Cuyonon
czh	Huizhou Chinese
czk	Knaanic
czn	Zenzontepec Chatino
czo	Min Zhong Chinese
czt	Zotung Chin
daa	Dangaléat
dac	Dambi
dad	Marik
dae	Duupa
dag	Dagbani
dah	Gwahatike
dai	Day
daj	Dar Fur Daju
dak	Dakota
dal	Dahalo
dam	Damakawa
dan	Danish
dao	Daai Chin
daq	Dandami Maria
dar	Dargwa
das	Daho-Doo
dau	Dar Sila Daju
dav	Dawida
daw	Davawenyo
dax	Dayi
daz	Moi
dba	Bangime
dbb	Deno
dbd	Dadiya
dbe	Dabe
dbf	Edopi
dbg	Dogul Dom Dogon
dbi	Ejuele
dbj	Ida’an
dbl	Dyirbal
dbm	Duguri
dbn	Duriankere
dbo	Dulubu
dbp	Duwai
dbq	Daba
dbr	Dabarre
dbt	Ben Tey Dogon
dbu	Bondum Dom Dogon
dbv	Dungu
dbw	Bankan Tey Dogon
dby	Dibiyaso
dcc	Deccan
dcr	Negerhollands
dda	Dadi Dadi
ddd	Dongotono
dde	Doondo
ddg	Fataluku
ddi	West Goodenough
ddj	Jaru
ddn	Dendi
ddo	Dido
ddr	Dhudhuroa
dds	Donno So Dogon
ddw	Dawera-Daweloor
dec	Dagik
ded	Dedua
dee	Dewoin
def	Dezfuli
deg	Degema
deh	Dehwari
dei	Demisa
dek	Dek
dem	Dem
dep	Pidgin Delaware
deq	Dendi
der	Deori
des	Desano
deu	Standard German
dev	Domung
dez	Dengese
dga	Southern Dagaare
dgb	Bunoge Dogon
dgc	Casiguran Dumagat Agta
dgd	Dagaari Dioula
dge	Degenang
dgg	Doga
dgh	Dghwede
dgi	Northern Dagara
dgk	Dagba
dgl	Andaandi
dgn	Dagoman
dgo	Dogri
dgr	Tlicho
dgs	Dogoso
dgt	Ndra’ngith
dgw	Daungwurrung
dgx	Doghoro
dgz	Daga
dhd	Dhundari
dhg	Dhangu-Djangu
dhi	Dhimal
dhl	Dhalandji
dhm	Zemba
dhn	Dangi
dho	Dhodia
dhr	Dhargari
dhs	Dhaiso
dhu	Dhurga
dhv	Drehu
dhw	Danuwar
dhx	Dhungaloo
dia	Dia
dib	South Central Dinka
dic	Lakota Dida
did	Didinga
dif	Diyari
dig	Digo
dih	Kumiai
dii	Dimbong
dij	Dai
dik	Southwestern Dinka
dil	Dilling
dim	Dime
dio	Dibo
dip	Northeastern Dinka
diq	Southern Zazaki
dir	Dirim
dis	Dimasa
diu	Gciriku
div	Maldivian
diw	Northwestern Dinka
dix	Dixon Reef
diy	Diuwe
diz	Ding
dja	Djadjawurrung
djb	Djinba
djc	Dar Daju Daju
djd	Djamindjung
dje	Zarma
djf	Djangun
dji	Djinang
djj	Djeebbana
djk	Aukan
djm	Jamsay Dogon
djn	Djauan
djo	Jangkang
djr	Djambarrpuyngu
dju	Kapriman
djw	Djawi
dka	Dakpakha
dkg	Kadung
dkk	Dakka
dkr	Kuijau
dks	Southeastern Dinka
dkx	Mazagway-Hidi
dlg	Dolgan
dlk	Dahalik
dlm	Dalmatian
dln	Darlong
dma	Duma
dmb	Mombo Dogon
dmc	Gavak
dmd	Madhi Madhi
dme	Dugwor
dmg	Upper Kinabatangan
dmk	Dawoodi
dml	Dameli
dmm	Dama
dmo	Kemedzung
dmr	East Damar
dms	Dampelas
dmu	Tebi
dmv	Dumpas
dmw	Mudburra
dmx	Dema
dmy	Sowari
dna	Upper Grand Valley Dani
dnd	Daonda
dne	Ndendeule
dng	Dungan
dni	Lower Grand Valley Dani
dnj	Dan
dnk	Dengka
dnn	Dzùùngoo
dno	Ndrulo
dnr	Danaru
dnt	Mid Grand Valley Dani
dnu	Danau
dnv	Danu
dnw	Western Dani
dny	Dení
doa	Dom
dob	Dobu
doc	Northern Dong
doe	Doe
dof	Domu
doh	Dong
dok	Dondo
dol	Doso
don	Toura
doo	Dongo
dop	Lukpa
doq	Dominican Sign Language
dor	Dori’o
dos	Dogosé
dot	Dass
dov	Dombe
dow	Doyayo
dox	Mositacha
doy	Dompo
doz	Dorze
dpp	Papar
drb	Dair
drc	Minderico
drd	Darmiya
dre	Dolpo
drg	Rungus
dri	C’Lela
drl	Paakantyi
drn	West Damar
dro	Daro-Matu Melanau
drq	Dura
drs	Gedeo
drt	Drents
dru	Rukai
dry	Darai
dsb	Lower Sorbian
dse	Sign Language of the Netherlands
dsh	Daasanach
dsi	Disa
dsk	Dokshi
dsl	Danish Sign Language
dsn	Dusner
dso	Desiya
dsq	Tadaksahak
dsz	Mardin Sign Language
dta	Daur
dtb	Labuk-Kinabatangan Kadazan
dtd	Ditidaht
dth	Adithinngithigh
dti	Ana Tinga Dogon
dtk	Tene Kan Dogon
dtm	Tomo Kan Dogon
dtn	Daatsʼíin
dto	Tommo So Dogon
dtp	Kadazan Dusun
dtr	Lotud
dts	Toro So Dogon
dtt	Toro Tegu Dogon
dtu	Tebul Ure Dogon
dty	Dotyali
dua	Duala
dub	Dubli
duc	Duna
due	Umiray Dumaget Agta
duf	Drubea
dug	Chiduruma
duh	Dungra Bhil
dui	Dumun
duk	Uyajitaya
dul	Inagta Alabat
dun	Dusun Deyah
duo	Dupaninan Agta
dup	Duano
duq	Dusun Malang
dur	Dii
dus	Dumi
duu	Drung
duv	Duvle
duw	Dusun Witu
dux	Duungooma
duy	Dicamay Agta
duz	Duli-Gey
dva	Duau
dwa	Dirya
dwk	Dawik Kui
dwr	Dawro
dwu	Dhuwal
dww	Dawawa
dwy	Dhuwaya
dwz	Dewas Rai
dya	Dyan
dyb	Dyaberdyaber
dyd	Dyugun
dyg	Villa Viciosa Agta
dyi	Djimini Sénoufo
dym	Yanda Dom Dogon
dyn	Dyangadi
dyo	Jola-Fonyi
dyr	Dyarim
dyu	Jula
dyy	Djabugay
dza	Tunzuii
dzd	Daza
dze	Djiwarli
dzg	Dazaga
dzl	Dzalakha
dzn	Dzando
dzo	Dzongkha
eaa	Karenggapa
ebc	Beginci
ebg	Ebughu
ebk	Eastern Bontok
ebo	Teke-Eboo
ebr	Tchaman
ebu	Kiembu
ecs	Ecuadorian Sign Language
eee	E
efa	Efai
efe	Efe
efi	Efik
ega	Ega
egl	Emilian
egm	Benamanga
ego	Eggon
ehs	Miyakubo Sign Language
ehu	Ehueun
eip	Lik
eit	Eitiep
eiv	Askopan
eja	Ejamat
eka	Ekajuk
eke	Ekit
ekg	Ekari
eki	Eki
ekk	Standard Estonian
ekl	Kol
ekm	Nulibie
eko	Koti
ekp	Ekpeye
ekr	Yace
eky	Eastern Kayah
ele	Elepi
elh	El Hugeirat
eli	Nding
elk	Elkei
ell	Greek
elm	Eleme
elo	El Molo
elu	Elu
ema	Emai-Iuleha-Ora
emb	Embaloh
eme	Tekó
emg	Eastern Mewahang
emi	Mussau-Emira
emk	Eastern Maninkakan
emm	Mamulique
emn	Eman
emp	Northern Emberá
emq	Eastern Minyag
ems	Pacific Gulf Yupik
emu	Eastern Muria
emw	Emplawas
emx	Erromintxela
emz	Mbessa
ena	Apal
enb	Markweeta
enc	En
end	Ende
enf	Forest Enets
eng	English
enh	Tundra Enets
enl	Enlhet
enn	Engenni
eno	Enggano
enq	Enga
enr	Emem
enu	Enu
env	Enwan
enw	Enwan
enx	Enxet
eot	Beti
epi	Epie
era	Eravallan
erg	Sie
erh	Eruwa
eri	Ogea
erk	South Efate
ero	Horpa
err	Erre
ers	Ersu
ert	Eritai
erw	Erokwanas
ese	Ese Eja
esg	Aheri Gondi
esh	Eshtehardi
esi	North Alaskan Inupiatun
esk	Northwest Alaska Inupiatun
esl	Egyptian Sign Language
esm	Esuma
esn	Salvadoran Sign Language
eso	Estonian Sign Language
esq	Esselen
ess	Saint Lawrence Island Yupik
esu	Central Yupik
esy	Eskayan
etb	Etebi
etc	Etchemin
eth	Ethiopian Sign Language
etn	Eton
eto	Eton
etr	Edolo
ets	Etsako
etu	Ejagham
etx	Iten
etz	Semimi
eud	Eudeve
eus	Basque
eve	Even
evh	Uvbie
evn	Evenki
ewe	Éwé
ewo	Ewondo
ext	Extremaduran
eya	Eyak
eyo	Keiyo
eza	Ezaa
eze	Uzekwe
faa	Fasu
fab	Fa d’Ambu
fad	Wagi
faf	Fagani
fag	Finongan
fah	Fali of Baissa
fai	Faiwol
faj	Kursav
fak	Fang
fal	South Fali
fam	Fam
fan	Fang
fao	Faroese
fap	Paloor
far	Fataleka
fau	Fayu
fax	Fala
fay	Southwestern Fars
fbl	West Albay Bikol
fcs	Quebec Sign Language
fer	Feroge
ffi	Foia Foia
ffm	Maasina Fulfulde
fgr	Fongoro
fia	Nobiin
fie	Fyer
fif	Faifi
fij	Fijian
fil	Filipino
fin	Finnish
fip	Fipa
fir	Firan
fit	Meänkieli
fiw	Fiwaga
fkk	Kirya-Konzel
fkv	Kven Finnish
fla	Kalispel-Pend d’Oreille
flh	Foau
fli	Fali Muchella
fll	North Fali
fln	Flinders Island
flr	Fuliiru
fly	Flaaitaal
fmp	Fe’fe’
fmu	Far Western Muria
fnb	Fanbak
fng	Pidgin Bantu
fni	Fania
fod	Foodo
foi	Foi
fom	Foma
fon	Fon
for	Fore
fos	Siraya
fpe	Equatorial Guinean Pidgin
fqs	Momu
fra	French
frc	Cajun French
frd	Fordata
frp	Arpitan
frq	Forak
frr	Northern Frisian
frs	East Frisian Low Saxon
frt	Kiae
fry	Frisian
fse	Finnish Sign Language
fsl	French Sign Language
fss	Finland-Swedish Sign Language
fub	Adamawa Fulfulde
fuc	Pulaar
fud	East Futuna
fue	Borgu Fulfulde
fuf	Pular
fuh	Western Niger Fulfulde
fui	Bagirmi Fulfulde
fuj	Ko
fum	Fum
fun	Iatê
fuq	Central-Eastern Niger Fulfulde
fur	Friulian
fut	Futuna-Aniwa
fuu	Fulu
fuv	Nigerian Fulfulde
fuy	Fuyug
fvr	Fur
fwa	Fwâi
fwe	Fwe
gaa	Ga
gab	Gabri
gac	Mixed Great Andamanese
gad	Gaddang
gae	Guarequena
gaf	Gende
gag	Gagauz
gah	Alekano
gai	Mbore
gaj	Gadsup
gak	Gamkonora
gal	Galolen
gam	Kandawo
gan	Gan Chinese
gao	Gants
gap	Gal
gaq	Gata’
gar	Galeya
gas	Adiwasi Garasia
gat	Aziana
gau	Mudhili Gadaba
gaw	Nobonob
gax	Borana-Arsi-Guji Oromo
gay	Gayo
gaz	West Central Oromo
gbb	Kaytetye
gbd	Karajarri
gbe	Niksek
gbf	Gaikundi
gbg	Gbanziri
gbh	Defi Gbe
gbi	Galela
gbj	Bodo Gadaba
gbk	Gaddi
gbl	Gamit
gbm	Garhwali
gbn	Mo’da
gbo	Northern Grebo
gbp	Gbaya-Bossangoa
gbq	Gbaya-Bozoum
gbr	Gbagyi
gbs	Gbesi Gbe
gbu	Gagadu
gbv	Gbanu
gbw	Gabi-Gabi
gbx	Eastern Xwla Gbe
gby	Gbari
gbz	Zoroastrian Dari
gcc	Mali
gcd	Ganggalida
gce	Galice
gcf	Guadeloupean French Creole
gcl	Grenadian English Creole
gcn	Gaina
gcr	Guianese French Creole
gct	Colonia Tovar German
gda	Gade Lohar
gdb	Pottangi Ollar Gadaba
gdc	Gugu Badhun
gdd	Gedaged
gde	Gude
gdf	Guduf-Gava
gdg	Gaꞌdang
gdh	Gadjerawang
gdi	Gundi
gdj	Gurdjar
gdk	Gadang
gdl	Dirasha
gdm	Laal
gdn	Umanakaina
gdo	Ghodoberi
gdq	Mehri
gdr	Wipi
gds	Ghandruk Sign Language
gdt	Kungardutyi
gdu	Gudu
gdx	Godwari
gea	Geruma
geb	Kire
gec	Gboloo Grebo
ged	Gade
gef	Gerai
geg	Gengle
geh	Hutterite German
gei	Gebe
gej	Gen
gek	Ywom
gel	ut-Ma’in
geq	Geme
ges	Geser-Gorom
gev	Eviya
gew	Gera
gex	Garre
gey	Enya
gez	Geez
gfk	Patpatar
gft	Gafat
gga	Gao
ggb	Gbii
ggd	Gugadj
gge	Gurr-goni
ggg	Gurgula
ggk	Kungarakany
ggl	Ganglau
ggt	Gitua
ggu	Gban
ggw	Gogodala
gha	Ghadamès
ghe	Southern Ghale
ghh	Northern Ghale
ghk	Geko Karen
ghl	Ghulfan
ghn	Ghanongga
gho	Ghomara
ghr	Ghera
ghs	Guhu-Samane
ght	Kuke
gia	Kija
gib	Gibanawa
gic	Gail
gid	Gidar
gie	Guébie
gig	Goaria
gih	Githabul
gii	Girirra
gil	Kiribati
gim	Gimi
gin	Hinukh
gip	Gimi
giq	Green Gelao
gir	Red Gelao
gis	North Giziga
git	Gitxsan
giu	Mulao
giw	Duoluo
gix	Gilima
giy	Giyug
giz	Giziga
gjk	Kachi Koli
gjm	Gunditjmara
gjn	Gonja
gjr	Gurindji Kriol
gju	Gojri
gka	Guya
gkd	Magɨ
gke	Ndai
gkn	Gokana
gko	Kok-Nar
gkp	Guinea Kpelle
gku	‡Ungkue
gla	Scottish Gaelic
glb	Belning
glc	Bon Gula
gld	Nanai
gle	Irish
glg	Galician
glh	Northwest Pashai
glj	Gula Iro
glk	Gilaki
gll	Garlali
glo	Galambi
glr	Glaro-Twabo
glu	Gula
glv	Manx
glw	Glavda
gly	Gule
gma	Gambera
gmb	Gula’alaa
gmd	Mághdì
gmg	Magiyi
gmm	Gbaya-Mbodomo
gmn	Gimnime
gmr	Mirning
gmu	Gumalu
gmv	Gamo
gmx	Magoma
gmz	Mgbolizhia
gna	Kaansa
gnb	Gangte
gnc	Guanche
gnd	Zulgo-Gemzek
gne	Ganang
gng	Ngangam
gnh	Lere
gni	Gooniyandi
gnj	Ngen
gnk	ǁGana
gnl	Gangulu
gnm	Ginuman
gnn	Gumatj
gno	Northern Gondi
gnq	Gana
gnr	Gureng Gureng
gnt	Wartha Thuntai
gnu	Gnau
gnw	Western Bolivian Guaraní
gnz	Ganzi
goa	Guro
gob	Playero
goc	Gorakor
god	Godié
goe	Gongduk
gof	Gofa
gog	Gogo
goi	Gebusi
goj	Gowlan
gok	Gowli
gol	Gola
gom	Goan Konkani
goo	Gone Dau
gop	Yeretuar
goq	Gorap
gor	Gorontalo
gos	Gronings
gou	Gavar
gov	Goo
gow	Gorowa
gox	Gubu
goy	Goundo
goz	Gozarkhani
gpa	Gupa-Abawa
gpe	Ghanaian Pidgin English
gpn	Tayap
gqa	Ga’anda
gqi	Guiqiong
gqn	Guana
gqr	Gor
gqu	Qau
gra	Rajput Garasia
grc	Ancient Greek
grd	Guruntum-Mbaaru
grg	Madi
grh	Tugbiri-Niragu
gri	Ghari
grj	Southern Grebo
grm	Kota Marudu Talantang
gro	Groma
grq	Gorovu
grr	Taznatit
grs	Gresi
grt	Garo
gru	Kistane
grv	Central Grebo
grw	Gweda
grx	Muno
gry	Barclayville Grebo
grz	Guramalum
gse	Ghanaian Sign Language
gsg	German Sign Language
gsl	Gusilay
gsm	Guatemalan Sign Language
gsn	Nema
gso	Southwest Gbaya
gsp	Wasembo
gss	Greek Sign Language
gsw	Alemannic
gta	Guató
gtu	Aghu-Tharnggala
gua	Shiki
gub	Guajajára
guc	Wayuu
gud	Yocoboué Dida
gue	Gurindji
guf	Gupapuyngu
gug	Paraguayan Guaraní
guh	Guahibo
gui	Eastern Bolivian Guaraní
guj	Gujarati
guk	Gumuz
gul	Sea Island English Creole
gum	Misak
gun	Mbyá Guaraní
guo	Guayabero
gup	Gunwinggu
guq	Aché
gur	Farefare
gus	Guinean Sign Language
gut	Maléku Jaíka
guu	Yanomamö
guw	Gun
gux	Gourmanchéma
guz	Gusii
gva	Guana
gvc	Guanano
gve	Duwet
gvf	Golin
gvj	Guajá
gvl	Gulay
gvm	Gurmana
gvn	Kuku-Yalanji
gvo	Gavião do Jiparaná
gvp	Pará Gavião
gvr	Gurung
gvs	Gumawana
gvy	Guyani
gwa	Mbato
gwb	Gwa
gwc	Gawri
gwd	Ale
gwe	Gweno
gwf	Gowro
gwg	Moo
gwi	Gwich’in
gwj	ǀGwi
gwm	Awngthim
gwn	Gwandara
gwr	Gwere
gwt	Gawarbati
gwu	Guwamu
gww	Kwini
gwx	Gua
gxx	Wè Southern
gya	Northwest Gbaya
gyb	Garus
gyd	Kayardild
gye	Gyem
gyf	Gungabula
gyg	Gbayi
gyi	Gyele
gyl	Gayil
gym	Ngäbere
gyn	Guyanese English Creole
gyo	Gyalsumdo
gyr	Guarayu
gyy	Gunya
gyz	Gyaazi
gza	Ganza
gzi	Gazi
gzn	Gane
haa	Han
hab	Hanoi Sign Language
hac	Gurani
had	Hatam
hae	Eastern Oromo
haf	Haiphong Sign Language
hag	Hanga
hah	Hahon
haj	Hajong
hak	Hakka Chinese
hal	Halang
ham	Hewa
han	Hangaza
hao	Hakö
hap	Hupla
haq	Ha
har	Harari
has	Haisla
hat	Haitian Creole
hau	Hausa
hav	Havu
haw	Hawaiian
hax	Southern Haida
hay	Haya
haz	Hazaragi
hba	Hamba
hbb	Nya Huba
hbn	Heiban
hbo	Ancient Hebrew
hbu	Habun
hca	Andaman Hindi Creole
hch	Huichol
hdn	Northern Haida
hds	Honduran Sign Language
hdy	Hadiyya
hea	Northern Qiandong Miao
heb	Hebrew
hed	Herdé
heg	Helong
heh	Hehe
hei	Heiltsuk
hem	Hemba
her	Herero
hgm	Hai|ǁom
hgw	Haigwai
hhi	Hoia Hoia
hhr	Kerak
hhy	Hoyahoya
hia	Lamang
hib	Hibito
hid	Hidatsa
hif	Fiji Hindi
hig	Kamwe
hih	Pamosu
hii	Hinduri
hij	Hijuk
hik	Seit-Kaitetu
hil	Hiligaynon
hin	Hindi
hio	Tshuwau
hir	Himarimã
hiw	Hiw
hix	Hixkaryána
hji	Haji
hka	Kahe
hke	Hunde
hkh	Khah
hkk	Hunjara-Kaina Ke
hkn	Mel-Khaonh
hks	Hong Kong Sign Language
hla	Halia
hlb	Halbi
hld	Halang Doan
hle	Hlersu
hlt	Matu Chin
hma	Southern Mashan Miao
hmb	Humburi Senni Songhay
hmc	Central Huishui Miao
hmd	Large Flowery Miao
hme	Eastern Huishui Miao
hmf	Hmong Don
hmg	Southwestern Guiyang Miao
hmh	Southwestern Huishui Miao
hmi	Northern Huishui Miao
hmj	Ge
hml	Luopohe Miao
hmm	Central Mashan Miao
hmo	Hiri Motu
hmp	Northern Mashan Miao
hmq	Eastern Qiandong Miao
hmr	Hmar
hms	Southern Qiandong Miao
hmt	Hamtai
hmu	Hamap
hmv	Hmong Dô
hmw	Western Mashan Miao
hmy	Southern Guiyang Miao
hmz	Sinicized Miao
hna	Mina
hnd	Southern Hindko
hne	Chhattisgarhi
hng	Hungu
hnh	ǁAni
hni	Hani
hnj	Hmong Njua
hnn	Hanunoo
hno	Northern Hindko
hns	Sarnami Hindustani
hnu	Hung
hoa	Hoava
hob	Mari
hoc	Ho
hod	Holma
hoe	Horom
hoh	Hobyót
hoi	Holikachuk
hoj	Haroti
hol	Holu
hom	Homa
hoo	Holoholo
hop	Hopi
hor	Horo
hos	Ho Chi Minh City Sign Language
hot	Malei
hov	Hovongan
how	Honi
hoy	Holiya
hoz	Hozo
hpo	Hpon
hps	Hawai‘i Sign Language
hra	Hrangkhol
hrc	Niwer Mil
hre	Hre
hrk	Haruku
hrm	Horned Miao
hro	Haroi
hrp	Nhirrpi
hrt	Hértevin
hru	Hruso
hrv	Croatian
hrw	Warwar Feni
hrx	Hunsrik
hrz	Harzani
hsb	Upper Sorbian
hsh	Hungarian Sign Language
hsl	Hausa Sign Language
hsn	Xiang Chinese
hss	Harsusi
hti	Hoti
hto	Minika Witoto
hts	Hadza
htu	Hitu
hub	Wampís
huc	ǂ’Amkhoe
hud	Huaulu
hue	San Francisco del Mar Huave
huf	Humene
hug	Huachipaeri
huh	Huilliche
hui	Huli
huj	Northern Guiyang Miao
huk	Hulung
hul	Vula’a
hum	Hungana
hun	Hungarian
huo	Hu
hup	Hupa
huq	Tsat
hur	Halkomelem
hus	Huastec
hut	Humla
huu	Murui Witoto
huv	San Mateo del Mar Huave
huw	Hukumina
hux	Muinani Witoto
huy	Hulaulá
huz	Hunzib
hvc	Haitian Vodoun Culture Language
hve	San Dionisio del Mar Huave
hvk	Haveke
hvn	Hawu
hvv	Santa María del Mar Huave
hwa	Wané
hwc	Hawaii Pidgin
hwo	Hwana
hya	Hya
hye	Armenian
hyw	Western Armenian
iai	Iaai
ian	Iatmul
iar	Purari
iba	Iban
ibb	Ibibio
ibd	Iwaidja
ibe	Akpes
ibg	Ibanag
ibh	Bih
ibl	Ibaloi
ibm	Robambami
ibn	Ibino
ibo	Igbo
ibr	Ibuoro
ibu	Ibu
iby	Ibani
ica	Ede Ica
ich	Etkywan
icl	Icelandic Sign Language
icr	Islander English Creole
ida	Luidakho-Luisukha-Lutirichi
idb	Indo-Portuguese
idc	Ajiya
idd	Ede Idaca
ide	Idere
idi	Idi
idr	Indri
ids	Idesa
idt	Idaté
idu	Idoma
ifa	Amganad Ifugao
ifb	Batad Ifugao
ife	Ifè
iff	Ifo
ifk	Tuwali Ifugao
ifm	Teke-Wuumu
ifu	Mayoyao Ifugao
ify	Keley-i Kallahan
igb	Ebira
ige	Igede
igg	Igana
igl	Igala
igm	Kanggape
ign	Ignaciano
igo	Isebe
igw	Igwe
ihb	Iha Based Pidgin
ihi	Ihievbe
ihp	Iha
ihw	Bidhawal
iii	Nuosu
iin	Thiin
ijc	Izon
ije	Biseni
ijj	Ede Ije
ijn	Kalabari
ijs	Southeast Ijo
ike	Eastern Canadian Inuktitut
ikh	Ikhin-Aokho
iki	Iko
ikk	Ika
ikl	Ikulu
iko	Olulumo-Ikom
ikp	Ikpeshi
ikr	Ikaranggal
iks	Inuit Sign Language
ikt	Inuinnaqtun
ikv	Iku-Gora-Ankwa
ikw	Ikwere
ikx	Ik
ikz	Ikizu
ila	Ile Ape
ilb	Ila
ilg	Garig-Ilgar
ili	Ili Turki
ilk	Bogkalot
ilm	Iranun
ilo	Ilocano
ilp	Iranun
ils	International Sign
ilu	Ili’uun
ilv	Ilue
ima	Mala Malasar
imi	Anamuxra
iml	Miluk
imn	Imonda
imo	Imbongu
imr	Imroing
imt	Imotong
inb	Inga
ind	Indonesian
ing	Deg Xinag
inh	Ingush
inj	Jungle Inga
inl	Indonesian Sign Language
inn	Isinay
ino	Inoke-Yate
inp	Iñapari
ins	Indian Sign Language
int	Intha
inz	Ineseño
ior	Inor
iou	Tuma-Irumu
iow	Iowa-Oto
ipi	Ipili
ipo	Ipiko
iqu	Iquitu
iqw	Ikwo
ire	Yeresiam
irh	Irarutu
iri	Rigwe
irk	Iraqw
irn	Irántxe
irr	Ir
iru	Irula
irx	Kamberau
iry	Iraya
isa	Isabi
isc	Isconahua
isd	Isnag
ise	Italian Sign Language
isg	Irish Sign Language
ish	Esan
isi	Nkem-Nkum
isk	Ishkashimi
isl	Icelandic
ism	Masimasi
isn	Isanzu
iso	Isoko
isr	Israeli Sign Language
ist	Istriot
isu	Isu
ita	Italian
itb	Binongan Itneg
itd	Southern Tidung
ite	Itene
iti	Inlaud Itneg
itk	Judeo-Italian
itl	Itelmen
itm	Itu Mbon Uzo
ito	Itonama
itr	Yawuno Teneyo
its	Isekiri
itt	Maeng Itneg
itv	Itawit
itw	Ito
itx	Itik
ity	Moyadan Itneg
itz	Itza’
ium	Iu Mien
ivb	Ibatan
ivv	Ivatan
iwk	I-wak
iwm	Iwam
iwo	Morop
iws	Sepik Iwam
ixc	Ixcatec
ixl	Ixil
iya	Iyayu
iyo	Mesaka
iyx	Yaka
izh	Ingrian
izm	Kizamani
izr	Izere
izz	Izii
jaa	Jamamadí
jab	Hyam
jac	Jakalteko
jad	Jahanka
jae	Yabem
jaf	Jara
jah	Jah Hut
jaj	Zazao
jak	Jakun
jal	Yalahatan
jam	Jamaican English Creole
jan	Jandai
jao	Yanyuwa
jaq	Yaqay
jas	New Caledonian Javanese
jat	Inku
jau	Yaur
jav	Javanese
jax	Jambi Malay
jay	Yan-nhangu
jaz	Jawe
jbe	Judeo-Berber
jbi	Badjiri
jbj	Arandai
jbk	Barikewa
jbm	Bijim
jbn	Nafusi
jbr	Jofotek-Bromnya
jbt	Jabutí
jbu	Jukun Takum
jbw	Yawijibaya
jcs	Konchri Sain
jct	Krimchak
jda	Jad
jdg	Jadgali
jdt	Judeo-Tat
jeb	Jebero
jee	Jerung
jeh	Jeh
jei	Yei
jek	Jeri Kuo
jel	Yelmek
jen	Dza
jer	Jere
jet	Manem
jeu	Jonkor Bourmataguil
jgb	Ngbee
jge	Judeo-Georgian
jgk	Gwak
jgo	Ngomba
jhi	Jehai
jhs	Jhyankot Sign Language
jia	Jina
jib	Jibu
jic	Tol
jid	Bu
jie	Jilbe
jig	Jingulu
jih	sTodsde
jii	Jiiddu
jil	Jilim
jim	Jimjimen
jio	Jiamao
jiq	Lavrung
jit	Jita
jiu	Youle Jinuo
jiv	Shuar
jiy	Buyuan Jinuo
jje	Jejueo
jjr	Bankal
jka	Kaera
jkm	Mobwa Karen
jko	Kubo
jkp	Paku Karen
jkr	Koro
jks	Amami Koniya Sign Language
jku	Labir
jle	Ngile
jls	Jamaican Sign Language
jma	Dima
jmb	Zibinju
jmc	Machame
jmd	Yamdena
jmi	Jimi
jml	Jumli
jmn	Makuri Naga
jmr	Kamara
jms	Mashi
jmw	Mouwase
jmx	Western Juxtlahuaca Mixtec
jna	Jangshung
jnd	Jandavra
jng	Yangman
jni	Janji
jnj	Yemsa
jnl	Rawat
jns	Jaunsari
job	Kiviila
jod	Wojenaka
jog	Jogi
jor	Jorá
jos	Jordanian Sign Language
jow	Jowulu
jpn	Japanese
jpr	Dzhidi
jqr	Jaqaru
jra	Jarai
jrr	Jiru
jrt	Jakattoe
jru	Japreria
jsl	Japanese Sign Language
jua	Júma
jub	Wannu
juc	Jurchen
jud	Worodougou
juh	Hõne
jui	Ngadjuri
juk	Wapan
jul	Jirel
jum	Jumjum
jun	Juang
juo	Jiba
jup	Hupdë
jur	Jurúna
jus	Jumli Sign Language
juu	Juu
juw	Wãpha
juy	Juray
jvd	Javindo
jvn	Suriname Javanese
jwi	Jwira-Pepesa
jya	Jiarong
jye	Judeo-Yemeni Arabic
jyy	Jaya
kaa	Karakalpak
kab	Kabyle
kac	Jingpho
kad	Adara
kae	Ketangalan
kaf	Katso
kag	Kajaman
kah	Kara
kai	Karekare
kaj	Jju
kak	Kalanguya
kal	Greenlandic
kam	Kamba
kan	Kannada
kao	Xaasongaxango
kap	Bezhta
kaq	Capanahua
kas	Kashmiri
kat	Georgian
kav	Katukína
kax	Kao
kay	Kamayurá
kaz	Kazakh
kba	Kalarko
kbb	Kaxuiâna
kbc	Kadiwéu
kbd	Kabardian
kbe	Kanju
kbg	Khamba
kbh	Camsá
kbi	Kaptiau
kbj	Kari
kbk	Koiari
kbl	Kanembu
kbm	Iwal
kbn	Kare
kbo	Keliko
kbp	Kabiyè
kbq	Kamano
kbr	Kafa
kbs	Kande
kbt	Abadi
kbu	Kabutra
kbv	Dla
kbw	Kaiep
kbx	Ap Ma
kby	Manga Kanuri
kbz	Duhwa
kca	Khanty
kcb	Kawacha
kcc	Lubila
kcd	Ngkâlmpw Kanum
kce	Kaivi
kcf	Ukaan
kcg	Tyap
kch	Vono
kci	Kamantan
kcj	Kobiana
kck	Kalanga
kcl	Kala
kcm	Gula
kcn	Nubi
kco	Kinalakna
kcp	Kanga
kcq	Kamo
kcr	Katla
kcs	Koenoem
kct	Kayan
kcu	Kami
kcv	Kete
kcw	Kabwari
kcx	Kachama-Ganjule
kcy	Korandje
kcz	Konongo
kda	Worimi
kdc	Kutu
kdd	Yankunytjatjara
kde	Makonde
kdf	Mamusi
kdg	Seba
kdh	Tem
kdi	Kumam
kdj	Ng’akarimojong
kdk	Numèè
kdl	Tsikimba
kdm	Gyong
kdn	Kunda
kdp	Nikyob-Nindem
kdq	Koch
kdr	Karaim
kdt	Kuay
kdu	Kadaru
kdw	Koneraw
kdx	Kam
kdy	Keijar
kdz	Kwaja
kea	Kabuverdianu
keb	Kélé
kec	Keiga
ked	Kerewe
kee	Eastern Keres
kef	Kpessi
keg	Tese
keh	Mevembet
kei	Kei
kej	Kadar
kek	Qꞌeqchiꞌ
kel	Kela
kem	Kemak
ken	Kenyang
keo	Kakwa
kep	Kaikadi
keq	Kamar
ker	Kera
kes	Kugbo
ket	Ket
keu	Akebu
kev	Kanikkaran
kew	West Kewapi
kex	Kukna
key	Kupia
kez	Kukele
kfa	Kodava
kfb	Northwestern Kolami
kfc	Konda-Dora
kfd	Korra Koraga
kfe	Kota
kff	Koya
kfg	Kudiya
kfh	Kurichiya
kfi	Kannada Kurumba
kfj	Kemiehua
kfk	Kinnauri
kfl	Kung
kfm	Khunsari
kfn	Kuk
kfo	Koro
kfp	Korwa
kfq	Korku
kfr	Kacchi
kfs	Bilaspuri
kft	Kanjari
kfu	Katkari
kfv	Kurmukar
kfw	Kharam Naga
kfx	Kullu Pahari
kfy	Kumaoni
kfz	Koromfé
kga	Koyaga
kgb	Kawe
kge	Komering
kgf	Kube
kgg	Kusunda
kgi	Selangor Sign Language
kgj	Gamal Kham
kgk	Kaiwá
kgl	Kunggari
kgn	Karingani
kgo	Krongo
kgp	Kaingang
kgq	Kamoro
kgr	Abun
kgs	Kumbainggar
kgt	Somyev
kgu	Kovol
kgv	Karas
kgw	Karon Dori
kgx	Kamaru
kgy	Kyirong
kha	Khasi
khb	Lü
khc	Tukang Besi North
khd	Bädi Kanum
khe	Korowai
khf	Khuen
khg	Khams Tibetan
khh	Kehu
khj	Kuturmi
khk	Halh Mongolian
khl	Lusi
khm	Khmer
khn	Khandesi
khp	Kapauri
khq	Koyra Chiini Songhay
khr	Kharia
khs	Kasua
kht	Khamti
khu	Nkumbi
khv	Khvarshi
khw	Khowar
khx	Kanu
khy	Kele
khz	Keapara
kia	Kim
kib	Koalib
kic	Kickapoo
kid	Koshin
kie	Kibet
kif	Eastern Parbate Kham
kig	Kimaghima
kih	Kilmeri
kii	Kitsai
kij	Kilivila
kik	Gikuyu
kil	Kariya
kim	Karagas
kin	Fumbira
kio	Kiowa
kip	Sheshi Kham
kiq	Kosare
kir	Kyrgyz
kis	Kis
kit	Agob
kiu	Northern Zazaki
kiv	Kimbu
kiw	Northeast Kiwai
kix	Khiamniungan Naga
kiy	Kirikiri
kiz	Kisi
kja	Mlap
kjb	Q’anjob’al
kjc	Coastal Konjo
kjd	Southern Kiwai
kje	Kisar
kjg	Khmu
kjh	Khakas
kji	Zabana
kjj	Khinalugh
kjk	Highland Konjo
kjl	Western Parbate Kham
kjm	Kháng
kjn	Kunjen
kjo	Pahari Kinnauri
kjp	Pwo West-Central Thailand Karen
kjq	Western Keres
kjr	Kurudu
kjs	East Kewapi
kjt	Phrae Pwo Karen
kju	Kashaya
kjx	Ramopa
kjy	Pole
kjz	Bumthangkha
kka	Kakanda
kkb	Kwerisa
kkc	Odoodee
kkd	Kinuku
kke	Kakabe
kkf	Kalaktang Monpa
kkg	Mabaka Valley Kalinga
kkh	Khün
kki	Kagulu
kkj	Kako
kkk	Kokota
kkl	Kosarek Yale
kkm	Kiong
kkn	Kon Keu
kko	Karko
kkp	Koko-Bera
kkq	Kaiku
kkr	Kir-Balar
kks	Giiwo
kkt	Koyee
kku	Tumi
kkv	Kangean
kkw	Teke-Kukuya
kkx	Kohin
kky	Guugu Yimidhirr
kkz	Kaska
kla	Klamath-Modoc
klb	Kiliwa
klc	Kolbila
kld	Gamilaraay
kle	Kulung
klf	Kendeje
klg	Tagakolu
klh	Weliki
kli	Kalumpang
klj	Khalaj
klk	Kono
kll	Kagan Kalagan
klm	Migum
klo	Kapya
klp	Kamasa
klq	Rumu
klr	Khaling
kls	Kalasha
klt	Nukna
klu	Klao
klv	Maskelynes
klw	Tado
klx	Koluwawa
kly	Kalao
klz	Kabola
kma	Konni
kmb	Kimbundu
kmc	Southern Dong
kmd	Majukayang Kalinga
kme	Bakole
kmf	Kare
kmg	Kâte
kmh	Kalam
kmi	Kami
kmj	Kumarbhag Paharia
kmk	Limos Kalinga
kml	Tanudan Kalinga
kmm	Kom
kmn	Awtuw
kmo	Kwoma
kmp	Gimme
kmq	Gwama
kmr	Northern Kurdish
kms	Kamasau
kmt	Kemtuik
kmu	Kanite
kmv	Karipuna French Creole
kmw	Komo
kmx	Waboda
kmy	Koma
kmz	Khorasani Turkish
kna	Dera
knb	Lubuagan Kalinga
knc	Yerwa Kanuri
knd	Konda
kne	Kankanaey
knf	Mankanya
kng	Koongo
kni	Kanufi
knj	Western Kanjobal
knk	Kuranko
knl	Keninjal
knm	Kanamarí
knn	Konkani
kno	Kono
knp	Kwanja
knq	Kintaq
knr	Kaningra
kns	Kensiu
knt	Panoan Katukína
knu	Kono
knv	Tabo
knw	Kung-Ekoka
knx	Salako
kny	Kanyok
knz	Sàmòmá
koa	Konomala
koc	Kpati
kod	Kodi
koe	Kacipo-Bale Suri
kof	Kubi
kog	Kogi
koh	Koyo
koi	Komi-Permyak
kol	Kol
koo	Konzo
kop	Waube
koq	Kota
kor	Korean
kos	Kosraean
kot	Lagwan
kou	Koke
kov	Kudu-Camo
kow	Kugama
koy	Koyukon
koz	Amako
kpa	Kutto
kpb	Mullu Kurumba
kpc	Curripaco
kpd	Koba
kpf	Komba
kpg	Kapingamarangi
kph	Kplang
kpi	Kofei
kpj	Karajá
kpk	Kpan
kpl	Kpala
kpm	Koho
kpn	Kepkiriwát
kpo	Ikposo
kpq	Korupun-Sela
kpr	Korafe-Yegha
kps	Tehit
kpt	Karata
kpu	Kafoa
kpv	Komi-Zyrian
kpw	Kobon
kpx	Mountain Koiali
kpy	Koryak
kpz	Kupsapiiny
kqa	Mum
kqb	Kovai
kqc	Doromu-Koki
kqd	Koy Sanjaq Surat
kqe	Kalagan
kqf	Kakabai
kqg	Khe
kqh	Kisankasa
kqi	Koita
kqj	Koromira
kqk	Kotafon Gbe
kql	Kyenele
kqm	Khisa
kqn	Kaonde
kqo	Eastern Krahn
kqp	Kimré
kqq	Krenak
kqr	Kimaragang
kqs	Northern Kissi
kqt	Klias River Kadazan
kqu	Seroa
kqv	Kolod Murut
kqw	Kandas
kqx	Mser
kqy	Koorete
kqz	Korana
kra	Kumal
krb	Karkin
krc	Karachay-Balkar
krd	Kairui-Midiki
kre	Panará
krf	Koro
krh	Kurama
kri	Krio
krj	Kinaray-a
krk	Kerek
krl	Karelian
krn	Sapo
krp	Durop
krr	Krung
krs	Gbaya
krt	Tumari Kanuri
kru	Kurux
krv	Kavet
krw	Western Krahn
krx	Karon
kry	Kryts
krz	Sota Kanum
ksb	Shambala
ksc	Southern Kalinga
ksd	Kuanua
kse	Kuni
ksf	Bafia
ksg	Kusaghe
ksh	Ripuarian
ksi	I’saka
ksj	Uare
ksk	Kansa
ksl	Kumalu
ksm	Kumba
ksn	Kasiguranin
kso	Kofa
ksp	Kaba
ksq	Kwaami
ksr	Borong
kss	Southern Kisi
kst	Winyé
ksu	Khamyang
ksv	Kusu
ksw	S’gaw Karen
ksx	Kedang
ksy	Kharia Thar
ksz	Kodaku
kta	Katua
ktb	Kambaata
ktc	Kholok
ktd	Kokata
kte	Nubri
ktf	Kwami
ktg	Kalkutung
kth	Karanga
kti	North Muyu
ktj	Plapo Krumen
ktk	Kaniet
ktl	Koroshi
ktm	Kurti
ktn	Karitiâna
kto	Kuot
ktp	Kaduo
kts	South Muyu
ktt	Ketum
ktu	Kituba
ktv	Eastern Katu
ktw	Kato
ktx	Kaxararí
kty	Kango
ktz	Juǀ’hoansi
kua	Kwanyama
kub	Kutep
kuc	Kwinsu
kud	’Auhelawa
kue	Kuman
kuf	Western Katu
kug	Kupa
kuh	Kushi
kui	Kuikúro-Kalapálo
kuj	Kuria
kuk	Kepo’
kul	Kulere
kum	Kumyk
kun	Kunama
kuo	Kumukio
kup	Kunimaipa
kuq	Karipuna
kus	Kusaal
kut	Kutenai
kuu	Upper Kuskokwim
kuv	Kur
kuw	Kpagua
kux	Kukatja
kuy	Kuuku-Ya’u
kuz	Kunza
kva	Bagvalal
kvb	Kubu
kvc	Kove
kvd	Kui
kve	Kalabakan Murut
kvf	Kabalai
kvg	Kuni-Boazi
kvh	Komodo
kvi	Kwang
kvj	Psikye
kvk	Korean Sign Language
kvl	Kayaw
kvm	Kendem
kvn	Border Kuna
kvo	Dobel
kvp	Kompane
kvq	Geba Karen
kvr	Kerinci
kvt	Lahta
kvu	Yinbaw
kvv	Kola
kvw	Wersing
kvx	Parkari Koli
kvy	Yintale
kvz	Tsaukambo
kwa	Dâw
kwb	Kwa
kwc	Likwala
kwd	Kwaio
kwe	Kwerba
kwf	Kwara’ae
kwg	Sara Kaba Démé
kwh	Kowiai
kwi	Awa-Cuaiquer
kwj	Kwanga
kwk	Kwakwala
kwl	Kofyar
kwm	Kwambi
kwn	Kwangali
kwo	Kwomtari
kwp	Kodia
kwr	Kwer
kws	Kwese
kwt	Kwesten
kwu	Kwakum
kwv	Sara Kaba Naa
kww	Kwinti
kwx	Khirwar
kwy	Kikongo
kwz	Kwadi
kxa	Kairiru
kxb	Krobu
kxc	Konso
kxd	Brunei
kxf	Kawyaw
kxh	Karo
kxi	Keningau Murut
kxj	Kulfa
kxk	Zayein
kxm	Northern Khmer
kxn	Kanowit-Tanjong Melanau
kxo	Kanoé
kxp	Wadiyari Koli
kxq	Smärky Kanum
kxr	Koro
kxs	Kangjia
kxt	Koiwat
kxv	Kuvi
kxw	Konai
kxx	Likuba
kxy	Kayong
kxz	Kerewo
kya	Kwaya
kyb	Butbut Kalinga
kyc	Kyaka
kyd	Karey
kye	Krache
kyf	Kouya
kyg	Keyagana
kyh	Karok
kyi	Kiput
kyj	Karao
kyk	Kamayo
kyl	Kalapuya
kym	Kpatili
kyn	Northern Binukidnon
kyo	Klon
kyp	Kang
kyq	Kenga
kyr	Kuruáya
kys	Baram Kayan
kyt	Kayagar
kyu	Western Kayah
kyv	Kewat
kyw	Kudmali
kyx	Rapoisi
kyy	Asa’a
kyz	Kayabí
kza	Western Karaboro
kzb	Kaibobo
kzc	Bondoukou Kulango
kzd	Kadai
kze	Kosena
kzf	Da’a Kaili
kzg	Kikai
kzi	Kelabit
kzk	Kazukuru
kzl	Kayeli
kzm	Kais
kzn	Kokola
kzo	Kaningi
kzp	Kaidipang
kzq	Kaike
kzr	Karang
kzs	Sugut Dusun
kzu	Kayupulau
kzv	Komyandaret
kzw	Karirí-Xocó
kzx	Kamarian
kzy	Kango
kzz	Kalabra
laa	Southern Subanen
lac	Lacandon
lad	Ladino
lae	Pattani
laf	Lafofa
lag	Rangi
lai	Lambya
laj	Lango
lal	Lalia
lam	Lamba
lan	Laru
lao	Lao
lap	Laka
laq	Qabiao
lar	Larteh
las	Lama
lat	Latin
lau	Laba
law	Lauje
lax	Tiwa
lay	Lama Bai
laz	Aribwatsa
lbb	Label
lbc	Lakkia
lbe	Lak
lbf	Tinani
lbg	Laopang
lbi	La’bi
lbj	Ladakhi
lbk	Central Bontok
lbl	Libon Bikol
lbm	Lodhi
lbn	Rmeet
lbo	Laven
lbq	Wampar
lbr	Lohorung
lbs	Libyan Sign Language
lbt	Lachi
lbu	Labu
lbv	Lavatbura-Lamusong
lbw	Tolaki
lbx	Lawangan
lby	Lamalama
lbz	Lardil
lcc	Legenyem
lcd	Lola
lce	Sekak
lcf	Lubu
lch	Luchazi
lcl	Lisela
lcm	Tungag
lcp	Western Lawa
lcq	Luhu
lcs	Lisabata-Nuniali
lda	Kla-Dan
ldb	Duya
ldd	Luri
ldg	Lenyima
ldh	Lamja-Dengsa-Tola
ldi	Laari
ldj	Lemoro
ldk	Leelau
ldl	Kaan
ldm	Landoma
ldo	Loo
ldp	Tso
ldq	Lufu
lea	Lega-Shabunda
leb	Lala-Bisa
lec	Leco
led	Lendu
lee	Lyélé
lef	Lelemi
leh	Lenje
lei	Lemio
lej	Lengola
lek	Leipon
lel	Lele
lem	Nomaande
len	Lenca
leo	Leti
lep	Lapcha
leq	Lembena
ler	Lenkau
les	Lese
let	Amio-Gelimi
leu	Kara
lev	Western Pantar
lew	Ledo Kaili
lex	Luang
ley	Limola
lez	Lezgi
lfa	Lefa
lga	Lungga
lgb	Laghu
lgg	Lugbara
lgh	Laghuu
lgi	Lengilu
lgk	Neverver
lgl	Wala
lgm	Lega-Mwenga
lgn	Opo
lgo	Lango
lgq	Logba
lgr	Lengo
lgs	Guinea-Bissau Sign Language
lgt	Pahi
lgu	Longgu
lgz	Ligenza
lha	Laha
lhh	Laha
lhi	Lahu Shi
lhl	Lahul Lohar
lhm	Lhomi
lhn	Lahanan
lhp	Lhokpu
lhs	Mlahsö
lht	Lo-Toga
lhu	Lahu
lia	West-Central Limba
lib	Likum
lic	Hlai
lid	Nyindrou
lie	Likila
lif	Limbu
lig	Ligbi
lih	Lihir
lij	Monégasque
lik	Lika
lil	Lillooet
lim	Limburgish
lin	Lingala
lio	Liki
lip	Sekpele
liq	Libido
lir	Liberian English
lis	Lisu
lit	Lithuanian
liu	Logorik
liv	Liv
liw	Col
lix	Liabuku
liy	Banda-Bambari
liz	Libinza
lja	Golpa
lje	Rampi
lji	Laiyolo
ljl	Li’o
ljp	Lampung Api
ljw	Yirandali
ljx	Yuru
lka	Lakalei
lkb	Lukabaras
lkc	Kucong
lkd	Lakondê
lke	Kenye
lkh	Lakha
lki	Laki
lkj	Remun
lkl	Laeko-Libuat
lkm	Kalaamaya
lkn	Lakon
lko	Olukhayo
lkr	Päri
lks	Olushisa
lkt	Lakota
lku	Kungkari
lky	Lokoya
lla	Lala-Roba
llb	Lolo
llc	Lele
lld	Ladin
lle	Lele
llf	Hermit
llg	Lole
llh	Lamu
lli	Teke-Laali
llj	Ladji Ladji
llk	Lelak
lll	Lilau
llm	Lasalimu
lln	Lele
llp	North Efate
llq	Lolak
lls	Lithuanian Sign Language
llu	Lau
llx	Lauan
lma	East Limba
lmb	Merei
lmc	Limilngan
lmd	Lumun
lme	Pévé
lmf	Painara
lmg	Lamogai
lmh	Mugali
lmi	Lombi
lmj	Labalekan-Mingar
lmk	Lamkang
lml	Hano
lmn	Lambadi
lmo	Lombard
lmp	Limbum
lmq	Lamatuka
lmr	Lamalera
lmu	Lamenu
lmv	Lomaiviti
lmw	Lake Miwok
lmx	Laimbue
lmy	Lamboya
lna	Langbashe
lnb	Mbalanhu
lnd	Lundayeh
lnh	Lanoh
lni	Daantanai’
lnj	Leningitij
lnl	South Central Banda
lnm	Pondi
lnn	Lorediakarkar
lns	Lamnsoʼ
lnu	Longuda
lnw	Lanima
lnz	Lonzo
loa	Loloda
lob	Lobi
loc	Inonhan
loe	Saluan
lof	Logol
log	Logo
loh	Laarim
loi	Loma
loj	Lou
lok	Loko
lol	Mongo-Nkundu
lom	Loma
lon	Malawi Lomwe
loo	Lombo
lop	Lopa
loq	Lobala
lor	Téén
los	Loniu
lot	Otuho
lou	Louisiana Creole
lov	Lopi
low	Tampias Lobu
lox	Loun
loy	Lhowa
loz	Lozi
lpa	Lelepa
lpe	Lepki
lpn	Long Phuri Naga
lpo	Lipo
lpx	Lopit
lqr	Logir
lra	Rara Bakati’
lrc	Northern Luri
lre	Laurentian
lrg	Laragia
lri	Olumarachi
lrk	Loarki
lrl	Lari
lrm	Olumarama
lrn	Lorang
lro	Laro
lrr	Southern Yamphu
lrt	Larantuka Malay
lrv	Larevat
lrz	Lemerig
lsa	Lasgerdi
lsb	Burundian Sign Language
lsc	Albarradas Sign Language
lsd	Lishana Deni
lse	Lusengo
lsh	Lish
lsi	Lacid
lsl	Latvian Sign Language
lsm	Saamya-Gwe
lsn	Tibetan Sign Language
lso	Laos Sign Language
lsp	Panamanian Sign Language
lsr	Aruop
lss	Lasi
lst	Trinidad and Tobago Sign Language
lsv	Sivia Sign Language
lsw	Seychelles Sign Language
lsy	Mauritian Sign Language
ltg	Latgalian
lth	Thur
lti	Leti
ltn	Latundê
lto	Olutsotso
lts	Lutachoni
ltu	Latu
ltz	Luxembourgish
lua	Luba-Kasai
lub	Luba-Katanga
luc	Aringa
lud	Ludian
lue	Luvale
luf	Laua
lug	Ganda
lui	Luiseño
luj	Luna
luk	Lunanakha
lul	Olu’bo
lum	Luimbi
lun	Lunda
luo	Luo
lup	Lumbu
luq	Lucumi
lur	Loura
lus	Mizo Chin
lut	Lushootseed
luu	Chhathare Yakkha
luv	Luwati
luw	Kasabe
luz	Southern Luri
lva	Makuva
lvi	Lavi
lvk	Lavukaleve
lvl	Lwel
lvs	Standard Latvian
lvu	Levuka
lwa	Lwalu
lwe	Lewoeleng
lwg	Oluwanga
lwh	White Lachi
lwl	Eastern Lawa
lwm	Laomian
lwo	Luwo
lws	Malawian Sign Language
lwt	Lewotobi
lwu	Lawu
lww	Lewo
lxm	Lakurumau
lya	Layakha
lyg	Lyngngam
lyn	Luyana
lzh	Classical Chinese
lzl	Litzlitz
lzn	Lainong Naga
lzz	Laz
maa	San Jerónimo Tecóatl Mazatec
mab	Yutanduchi Mixtec
mad	Madura
mae	Bo-Rukul
maf	Mafa
mag	Magahi
mah	Marshallese
mai	Maithili
maj	Jalapa de Díaz Mazatec
mak	Makasar
mal	Malayalam
mam	Mam
maq	Chiquihuitlán Mazatec
mar	Marathi
mas	Maasai
mat	San Francisco Matlatzinca
mau	Huautla Mazatec
mav	Sateré-Mawé
maw	Mampruli
max	North Moluccan Malay
maz	Central Mazahua
mba	Higaonon
mbb	Western Bukidnon Manobo
mbc	Macushi
mbd	Dibabawon Manobo
mbe	Molale
mbf	Baba Malay
mbh	Mangseng
mbi	Ilianen Manobo
mbj	Nadëb
mbk	Malol
mbl	Maxakalí
mbm	Ombamba
mbn	Macaguán
mbo	Mbo
mbp	Sanka
mbq	Maisin
mbr	Nukak Makú
mbs	Sarangani Manobo
mbt	Matigsalug Manobo
mbu	Mbula-Bwazza
mbv	Mbulungish
mbw	Maring
mbx	Mari
mby	Memoni
mbz	Amoltepec Mixtec
mca	Maka
mcb	Matsigenka
mcc	Bitur
mcd	Sharanahua
mce	Itundujia Mixtec
mcf	Matses
mcg	Mapoyo
mch	Maquiritari
mci	Mesem
mcj	Mvanip
mck	Mbunda
mcl	Macaguaje
mcm	Malaccan Portuguese Creole
mcn	Masana
mco	Coatlán Mixe
mcp	Makaa
mcq	Ese
mcr	Menya
mcs	Mambai
mct	Mengisa
mcu	Cameroon Mambila
mcv	Minanibai
mcw	Mawa
mcx	Mpiemo
mcy	South Kodut
mcz	Mawan
mda	Mada
mdb	Morigi
mdc	Soq
mdd	Mbum
mde	Maba
mdf	Moksha
mdg	Massalat
mdh	Maguindanaon
mdi	Mamvu
mdj	Mangbetu
mdk	Mangbutu
mdl	Maltese Sign Language
mdm	Mayogo
mdn	Mbati
mdp	Mbala
mdq	Mbole
mdr	Mandar
mds	Maria
mdt	Mbere
mdu	Mboko
mdv	Santa Lucía Monteverde Mixtec
mdw	Mbosi
mdx	Dizin
mdy	Male
mdz	Suruí do Pará
mea	Menka
meb	Ikobi
mec	Marra
med	Melpa
mee	Mengen
mef	Megam
meh	Southwestern Tlaxiaco Mixtec
mei	Midob
mej	Meyah
mek	Mekeo
mel	Central Melanau
mem	Mangala
men	Mende
meo	Satun Malay
mep	Miriwoong
meq	Merey
mer	Kimîîru
mes	Masmaje
met	Mato
meu	Motu
mev	Maan
mew	Maaka
mey	Hassaniyya
mez	Menominee
mfa	Pattani Malay
mfb	Bangka
mfc	Mba
mfd	Mendankwe-Nkwen
mfe	Morisyen
mff	Naki
mfg	Mogofin
mfh	Matal
mfi	Wandala
mfj	Mefele
mfk	North Mofu
mfl	Putai
mfm	Marghi South
mfn	Cross River Mbembe
mfo	Mbe
mfp	Makassar Indonesian
mfq	Moba
mfr	Marrithiyel
mfs	Mexican Sign Language
mft	Idio
mfu	Mbwela
mfv	Mandjak
mfw	Mulaha
mfx	Melo
mfy	Mayo
mfz	Mabaan
mgb	Mararit
mgc	Morokodo
mgd	Moru
mge	Mango
mgf	Maklew
mgg	Mpumpong
mgh	Makhuwa-Meetto
mgi	Migili
mgj	Abureni
mgk	Mawes
mgl	Maleu-Kilenge
mgm	Mambae
mgn	Mbangi
mgo	Meta’
mgp	Eastern Magar
mgq	Malila
mgr	Mambwe-Lungu
mgs	Manda
mgt	Mwakai
mgu	Magi
mgv	Matengo
mgw	Matumbi
mgy	Mbunga
mgz	Mbugwe
mha	Manda
mhb	Mahongwe
mhc	Mocho
mhd	Mbugu
mhe	Mah Meri
mhf	Doloman
mhg	Margu
mhi	Ma’di
mhj	Mogholi
mhk	Mungaka
mhl	Mauwake
mhm	Makhuwa-Moniga
mhn	Mòcheno
mho	Mashi
mhp	Balinese Malay
mhq	Mandan
mhr	Meadow Mari
mhs	Buru
mht	Mandahuaca
mhu	Digaro-Mishmi
mhw	Mbukushu
mhx	Lhao Vo
mhy	Ma’anyan
mhz	Mor
mia	Miami
mib	Atatlahuca Mixtec
mic	Mi’kmaq
mid	Neo-Mandaic
mie	Ocotepec Mixtec
mif	Mofu-Gudur
mig	San Miguel el Grande Mixtec
mih	Chayuco Mixtec
mii	Chigmecatitlán Mixtec
mij	Mungbam
mik	Mikasuki
mil	Peñoles Mixtec
mim	Alacatlatzala Mixtec
min	Minangkabau
mio	Pinotepa Nacional Mixtec
mip	Apasco-Apoala Mixtec
miq	Mískito
mir	Isthmus Mixe
mit	Southern Puebla Mixtec
miu	Cacaloxtepec Mixtec
miw	Akoye
mix	Mixtepec Mixtec
miy	Ayutla Mixtec
miz	Coatzospan Mixtec
mjb	Makalero
mjc	San Juan Colorado Mixtec
mjd	Northwest Maidu
mje	Muskum
mjg	Tu
mjh	Mwera
mji	Kim Mun
mjj	Mawak
mjk	Matukar Panau
mjl	Mandeali
mjm	Medebur
mjn	Ma
mjo	Malankuravan
mjp	Malapandaram
mjq	Malaryan
mjr	Malavedan
mjs	Miship
mjt	Sauria Paharia
mju	Manna-Dora
mjv	Mannan
mjw	Karbi
mjx	Mahali
mjy	Mahican
mjz	Majhi
mka	Mbre
mkb	Mal Paharia
mkc	Siliput
mkd	Macedonian
mke	Mawchi
mkf	Vune mi
mkg	Mak
mki	Dhatki
mkj	Mokilese
mkk	Byep
mkl	Mokole
mkm	Moklen
mkn	Kupang Malay
mko	Mingang Doso
mkp	Moikodi
mkq	Bay Miwok
mkr	Manep
mks	Silacayoapan Mixtec
mkt	Vamale
mku	Konyanka
mkv	Mafea
mkw	Kituba
mkx	Kinamiging Manobo
mky	East Makian
mkz	Makasae
mla	Malo
mlb	Mbule
mlc	Cao Lan
mle	Manambu
mlf	Mal
mlh	Mape
mli	Malimpung
mlj	Miltu
mlk	Kiwilwana
mll	Malua Bay
mlm	Mulam
mln	Malango
mlo	Mlomp
mlp	Bargam
mlq	Western Maninkakan
mlr	Vame
mls	Masalit
mlt	Maltese
mlu	To’abaita
mlv	Mwotlap
mlw	Moloko
mlx	Na’ahai
mlz	Malaynon
mma	Mama
mmb	Momina
mmc	Michoacán Mazahua
mmd	Maonan
mme	Mae
mmf	Mindat
mmg	North Ambrym
mmh	Mehináku
mmi	Hember Avu
mmj	Majhwar
mmk	Mukha-Dora
mml	Man Met
mmm	Maii
mmn	Minamanwa
mmo	Mangga Buang
mmp	Siawi
mmq	Aisi
mmr	Western Xiangxi Miao
mmt	Mala
mmu	Numala
mmv	Miriti
mmw	Emae
mmx	Madak
mmy	Migaama
mmz	Mabaale
mna	Mbula
mnb	Muna
mnc	Manchu
mnd	Mondé
mne	Naba
mnf	Mundani
mng	Eastern Mnong
mnh	Mono
mni	Meitei
mnj	Munji
mnk	Mandinka
mnl	Tiale
mnm	Mapena
mnn	Southern Mnong
mnp	Min Bei Chinese
mnq	Minriq
mnr	Mono
mns	Mansi
mnu	Mer
mnv	Rennell-Bellona
mnw	Mon
mnx	Sougb
mny	Manyawa
mnz	Moni
moa	Mwan
moc	Mocoví
mod	Mobilian
moe	Innu
mog	Mongondow
moh	Mohawk
moi	Mboi
moj	Monzombo
mok	Morori
mom	Mangue
moo	Monom
mop	Mopán Maya
moq	Mor
mor	Moro
mos	Moore
mot	Barí
mou	Mogum
mov	Mohave
mow	Moi
mox	Molima
moy	Shekkacho
moz	Mukulu
mpa	Mpoto
mpb	Malak Malak
mpc	Mangarrayi
mpd	Machinere
mpe	Majang
mpg	Marba
mph	Maung
mpi	Mpade
mpj	Martu Wangka
mpk	Mbara
mpl	Middle Kodut
mpm	Yosondúa Mixtec
mpn	Mindiri
mpo	Miu
mpp	Migabac
mpq	Matís
mpr	Vangunu
mps	Dadibi
mpt	Mian
mpu	Makuráp
mpv	Mungkip
mpw	Mapidian
mpx	Misima-Panaeati
mpy	Mapia
mpz	Mpi
mqa	Maba
mqb	Mbuko
mqc	Mangole
mqe	Matepi
mqf	Momuna
mqg	Kota Bangun Kutai Malay
mqh	Tlazoyaltepec Mixtec
mqi	Mariri
mqj	Mamasa
mqk	Rajah Kabunsuwan Manobo
mql	Mbelime
mqm	South Marquesan
mqn	Moronene
mqo	Modole
mqp	Manipa
mqq	Minokok
mqr	Mander
mqs	West Makian
mqt	Mok
mqu	Mandari
mqv	Mosimo
mqw	Murupi
mqx	Mamuju
mqy	Manggarai
mqz	Pano
mra	Mlabri
mrb	Marino
mrc	Maricopa
mrd	Western Magar
mre	Martha’s Vineyard Sign Language
mrf	Elseng
mrg	Mising
mrh	Mara
mri	Maori
mrj	Hill Mari
mrk	Hmwaveke
mrl	Mortlockese
mrm	Mwerlap
mrn	Cheke Holo
mro	Mru
mrp	Morouas
mrq	North Marquesan
mrr	Maria
mrs	Maragus
mrt	Marghi Central
mru	Mono
mrv	Mangareva
mrw	Maranao
mrx	Dineor
mry	Mandaya
mrz	Marind
msb	Masbatenyo
msc	Sankaran Maninka
msd	Yucatec Maya Sign Language
mse	Musey
msf	Mekwei
msg	Moraid
msh	Masikoro Malagasy
msi	Sabah Malay
msj	Ma
msk	Mansaka
msl	Molof
msm	Agusan Manobo
msn	Vurës
mso	Mombum
msp	Maritsauá
msq	Caac
msr	Mongolian Sign Language
mss	West Masela
msu	Musom
msv	Maslam
msw	Mansoanka
msx	Moresada
msy	Aruamu
msz	Momare
mta	Cotabato Manobo
mtb	Anyin Morofo
mtc	Munit
mtd	Mualang
mte	Mono
mtf	Murik
mtg	Una
mth	Munggui
mti	Maiwa
mtj	Moskona
mtk	Mbo’
mtl	Tehl
mtm	Mator
mtn	Matagalpa
mto	Totontepec Mixe
mtp	Weenhayek
mtq	Muong
mtr	Mewari
mts	Yora
mtt	Mota
mtu	Tututepec Mixtec
mtv	Asaro’o
mtw	Southern Binukidnon
mtx	Tidaá Mixtec
mty	Nabi
mua	Mundang
mub	Mubi
muc	Ajumbu
mud	Mednyj Aleut
mue	Media Lengua
mug	Musgu
muh	Mündü
mui	Musi
muj	Mabire
muk	Mugom-Karmarong
mum	Maiwala
muo	Mubako
mup	Malvi
muq	Eastern Xiangxi Miao
mur	Murle
mus	Muskogee
mut	Western Muria
muu	Yaaku
muv	Muthuvan
mux	Bo-Ung
muy	Muyang
muz	Mursi
mva	Manam
mvb	Mattole
mvd	Mamboru
mve	Marwari
mvf	Peripheral Mongolian
mvg	Yucuañe Mixtec
mvh	Mulgi
mvi	Miyako
mvk	Mekmek
mvl	Mbara
mvn	Minaveha
mvo	Marovo
mvp	Duri
mvq	Moere
mvr	Marau
mvs	Massep
mvt	Mpotovoro
mvu	Marfa
mvv	Tahol Murut
mvw	Machinga
mvx	Meoswar
mvy	Indus Kohistani
mvz	Mesqan
mwa	Mwatebu
mwb	Juwar
mwc	Are
mwe	Mwera
mwf	Murrinh-Patha
mwg	Aiklep
mwh	Mouk-Aria
mwi	Ninde
mwk	Kita Maninkakan
mwl	Mirandese
mwm	Sar
mwn	Nyamwanga
mwo	Central Maewo
mwp	Kala Lagaw Ya
mwq	Müün Chin
mws	Mwimbi-Muthambi
mwt	Moken
mwu	Mittu
mwv	Mentawai
mww	Hmong Daw
mwz	Moingi
mxa	Northwest Oaxaca Mixtec
mxb	Tezoatlán Mixtec
mxc	Manyika
mxd	Modang
mxe	Mele-Fila
mxf	Malgbe
mxg	Mbangala
mxh	Mvuba
mxj	Miju-Mishmi
mxk	Monumbo
mxl	Maxi Gbe
mxm	Meramera
mxn	Moi Kelim
mxo	Mbowe
mxp	Tlahuitoltepec Mixe
mxq	Juquila Mixe
mxr	Murik
mxs	Huitepec Mixtec
mxt	Jamiltepec Mixtec
mxu	Mada
mxv	Metlatónoc Mixtec
mxw	Namo
mxx	Mahou
mxy	Southeastern Nochixtlán Mixtec
mxz	Central Masela
mya	Burmese
myb	Mbay
myc	Mayeka
mye	Myene
myf	Mawes Aasse
myg	Manta
myh	Makah
myj	Mangayat
myk	Mamara Sénoufo
myl	Moma
mym	Me’en
myo	Anfillo
myp	Pirahã
myr	Muniche
mys	Mesmes
myu	Mundurukú
myv	Erzya
myw	Muyuw
myx	Masaaba
myy	Macuna
myz	Classical Mandaic
mza	Santa María Zacatepec Mixtec
mzb	Tumzabt
mzc	Malagasy Sign Language
mzd	Mulimba
mze	Morawa
mzh	Pilcomayo Wichí
mzi	Ixcatlán Mazatec
mzj	Manya
mzk	Nigeria Mambila
mzl	Mazatlán Mixe
mzm	Mumuye
mzn	Mazandarani
mzo	Matipuhy
mzp	Movima
mzq	Mori Atas
mzr	Marubo
mzs	Macanese
mzt	Mintil
mzu	Inapang
mzv	Mandja
mzw	Deg
mzx	Mawayana
mzy	Mozambican Sign Language
mzz	Maiadomu
naa	Namla
nab	Southern Nambikuára
nac	Narak
nae	Naka’ela
naf	Nabak
nag	Nagamese
naj	Nalu
nak	Nakanai
nal	Nalik
nam	Ngan’gityemerri
nan	Min Nan Chinese
nao	Naaba
nap	Napoletano
naq	Khoekhoe
nar	Iguta
nas	Naasioi
nat	Cahungwarya
nau	Nauruan
nav	Navajo
naw	Nawuri
nax	Nakwi
nay	Ngarrindjeri
naz	Coatepec Nahuatl
nba	Nyemba
nbb	Ndoe
nbc	Chang Naga
nbd	Ngbinda
nbe	Konyak Naga
nbg	Nagarchal
nbh	Ngamo
nbi	Mao Naga
nbj	Ngarinyman
nbk	Nake
nbl	Ndebele
nbm	Ngbaka Ma’bo
nbn	Kuri
nbo	Nkukoli
nbp	Nnam
nbq	Nggem
nbr	Numana
nbs	Namibian Sign Language
nbt	Na
nbu	Rongmei Naga
nbv	Ngamambo
nbw	Southern Ngbandi
nby	Ningera
nca	Iyo
ncb	Central Nicobarese
ncc	Ponam
ncd	Nachiring
nce	Yale
ncf	Notsi
ncg	Nisga’a
nch	Central Huasteca Nahuatl
ncj	Northern Puebla Nahuatl
nck	Na-kara
ncl	Michoacán Nahuatl
ncm	Nambo
ncn	Neherneh
nco	Sibe
ncq	Northern Katang
ncr	Nchane
ncs	Nicaraguan Sign Language
nct	Chothe Naga
ncu	Chumburung
ncx	Central Puebla Nahuatl
ncz	Natchez
nda	Ndasa
ndb	Kenswei Nsei
ndc	Ndau
ndd	Nde-Nsele-Nta
nde	Ndebele
ndg	Ndengereko
ndh	Ndali
ndi	Samba Leko
ndj	Ndamba
ndk	Ndaka
ndl	Ndolo
ndm	Ndam
ndn	Ngundi
ndo	Ndonga
ndp	Kebu
ndq	Ndombe
ndr	Ndoola
nds	Low Saxon
ndt	Ndunga
ndu	Dugun
ndv	Ndut
ndw	Ndobo
ndx	Nduga
ndy	Luto
ndz	Ndogo
nea	Eastern Ngad’a
neb	Toura
nec	Nedebang
ned	Nde-Gbite
nee	Nêlêmwa-Nixumwak
nef	Nefamese
neg	Negidal
neh	Nyenkha
nej	Neko
nek	Neku
nem	Nemi
nen	Nengone
neo	Ná-Meo
neq	North Central Mixe
ner	Yahadian
nes	Bhoti Kinnauri
net	Nete
nev	Nyaheun
new	Newar
nex	Neme
ney	Neyo
nez	Nez Perce
nfa	Dhao
nfd	Ahwai
nfl	Äiwoo
nfr	Nafaanra
nfu	Mfumte
nga	Ngbaka
ngb	Northern Ngbandi
ngc	Ngombe
ngd	Ngando
nge	Ngemba
ngg	Ngbaka Manza
ngh	Nǁng
ngi	Ngizim
ngj	Ngie
ngk	Dalabon
ngl	Lomwe
ngm	Ngatik Men’s Creole
ngn	Ngwo
ngp	Ngulu
ngq	Ngoreme
ngr	Engdewu
ngs	Gvoko
ngt	Kriang
ngu	Guerrero Nahuatl
ngv	Nagumi
ngw	Ngwaba
ngx	Nggwahyi
ngy	Tibea
ngz	Ngungwel
nha	Nhanda
nhb	Beng
nhc	Tabasco Nahuatl
nhd	Ava Guaraní
nhe	Eastern Huasteca Nahuatl
nhf	Nhuwala
nhg	Tetelcingo Nahuatl
nhh	Nahari
nhi	Zacatlán-Ahuacatlán-Tepetzintla Nahuatl
nhk	Isthmus-Cosoleacaque Nahuatl
nhm	Morelos Nahuatl
nhn	Central Nahuatl
nho	Takuu
nhp	Isthmus-Pajapan Nahuatl
nhq	Huaxcaleca Nahuatl
nhr	Naro
nht	Ometepec Nahuatl
nhu	Noone
nhv	Temascaltepec Nahuatl
nhw	Western Huasteca Nahuatl
nhx	Isthmus-Mecayapan Nahuatl
nhy	Northern Oaxaca Nahuatl
nhz	Santa María la Alta Nahuatl
nia	Nias
nib	Nakame
nid	Ngandi
nie	Niellim
nif	Nek
nig	Ngalakgan
nih	Nyiha
nii	Nii
nij	Ngaju
nik	Southern Nicobarese
nil	Nila
nim	Nilamba
nin	Ninzo
nio	Nganasan
niq	Nandi
nir	Nimboran
nis	Sama
nit	Southeastern Kolami
niu	Niue
niv	Gilyak
niw	Nimo
nix	Hema
niy	Ngiti
niz	Ningil
nja	Nzanyi
njb	Nocte Naga
njd	Ndonde Hamba
njh	Lotha Naga
nji	Gudanji
njj	Njen
njl	Njalgulgule
njm	Angami Naga
njn	Liangmai Naga
njo	Ao Naga
njr	Njerep
njs	Nisa
njt	Ndyuka-Trio Pidgin
nju	Ngadjunmaya
njx	Kunyi
njy	Njyem
njz	Nyishi
nka	Nkoya
nkb	Khoibu Naga
nkc	Nkongho
nkd	Koireng
nke	Dughore
nkf	Inpui Naga
nkg	Nekgini
nkh	Khezha Naga
nki	Thangal Naga
nkj	Nakai
nkk	Tanokuku
nkm	Namat
nkn	Nkangala
nko	Nkonya
nkp	Niuatoputapu
nkq	Nkami
nkr	Nukuoro
nks	North Asmat
nkt	Tanzania Nyika
nku	Bouna Kulango
nkv	Nyika
nkw	Nkutu
nkx	Nkoroo
nkz	Nkari
nla	Ngombale
nlc	Nalca
nld	Dutch
nle	Nyala
nlg	Gela
nli	Grangali
nlj	Nyali
nlk	Ninia Yali
nll	Nihali
nlm	Mankiyali
nlo	Ngwii
nlq	Lao Naga
nlu	Nchumbulu
nlv	Orizaba Nahuatl
nlw	Walangama
nlx	Nahali
nly	Nyamal
nlz	Nalögo
nma	Maram Naga
nmb	V’ënen Taut
nmc	Ngam
nmd	Ndumu
nme	Mzieme Naga
nmf	Tangkhul Naga
nmg	Kwasio
nmh	Monsang Naga
nmi	Nyam
nmj	Ngombe
nmk	Namakura
nml	Ndemli
nmm	Nyeshangte
nmn	Taa
nmo	Moyon Naga
nmp	Nimanbur
nmq	Nambya
nmr	Nimbari
nms	Letemboi
nmt	Namonuito
nmu	Northeast Maidu
nmv	Ngamini
nmw	Rifao
nmx	Nama
nmy	Namuyi
nmz	Nawdm
nna	Nyangumarta
nnb	Nande
nnc	Nancere
nnd	West Ambae
nne	Ngandjera
nnf	Ngaing
nng	Maring Naga
nnh	Ngiemboon
nni	North Nuaulu
nnj	Nyangatom
nnk	Nankina
nnl	Northern Rengma Naga
nnm	Namia
nnn	Ngete
nnp	Wancho Naga
nnq	Ngindo
nnr	Narungga
nnt	Nanticoke
nnu	Dwang
nnv	Nugunu
nnw	Southern Nuni
nny	Nyangga
nnz	Nda’nda’
noa	Woun Meu
noc	Nuk
nod	Northern Thai
noe	Nimadi
nof	Nomane
nog	Nogai
noh	Nomu
noi	Noiri
noj	Nonuya
nok	Nooksack
nol	Nomlaki
nop	Numanggang
noq	Ngongo
nor	Norwegian
nos	Eastern Nisu
not	Nomatsigenga
nou	Ewage-Notu
now	Nyambo
noy	Noy
noz	Nayi
npa	Nar Phu
npb	Nupbikha
npg	Ponyo-Gongwang Naga
nph	Phom Naga
npi	Nepali
npl	Southeastern Puebla Nahuatl
npn	Mondropolon
npo	Pochuri Naga
nps	Nipsan
npu	Puimei Naga
npx	Noipä
npy	Napu
nqg	Southern Nago
nqk	Kura Ede Nago
nql	Ngendelengo
nqm	Ndom
nqn	Nen
nqo	N’Ko
nqq	Chen-Kayu Naga
nqt	Nteng
nqy	Akyaung Ari Naga
nra	Ngom
nrb	Nara
nre	Southern Rengma Naga
nrf	Jèrriais
nrg	Varsaf
nri	Chokri Naga
nrk	Ngarla
nrl	Ngarluma
nrm	Narom
nrn	Norn
nrr	Nora
nrt	Northern Kalapuya
nru	Narua
nrx	Ngurmbur
nrz	Lala
nsa	Sangtam Naga
nsb	Lower Nossob
nsd	Southern Nisu
nse	Nsenga
nsf	Northwestern Nisu
nsg	Ngasa
nsh	Ngoshie
nsi	Nigerian Sign Language
nsk	Naskapi
nsl	Norwegian Sign Language
nsm	Sumi Naga
nsn	Nehan
nso	Northern Sotho
nsp	Nepalese Sign Language
nsq	Northern Sierra Miwok
nsr	Maritime Sign Language
nss	Nali
nst	Tangshang Naga
nsu	Sierra Negra Nahuatl
nsv	Southwestern Nisu
nsw	Balen
nsx	Songo
nsy	Nasal
nsz	Nisenan
ntd	Northern Tidung
nte	Nathembo
ntg	Ngantangarra
nti	Natioro
ntj	Ngaanyatjarra
ntk	Ikoma-Nata-Isenye
ntm	Nateni
nto	Ntomba
ntp	Northern Tepehuan
ntr	Delo
ntu	Natügu
ntw	Nottoway
ntx	Tangkhul Naga
nty	Mantsi
ntz	Natanzi
nua	Yuanga
nuc	Nukuini
nud	Gala
nue	Ngundu
nuf	Nusu
nug	Nungali
nuh	Ndunda
nui	Kombe
nuj	Nyole
nuk	Nuu-chah-nulth
nul	Nusa Laut
num	Niuafo’ou
nun	Anong
nuo	Nguôn
nup	Nupe-Nupe-Tako
nuq	Nukumanu
nur	Nukeria
nus	Nuer
nut	Nung
nuu	Ngbundu
nuv	Northern Nuni
nuw	Nguluwan
nux	Mehek
nuy	Nunggubuyu
nuz	Tlamacazapa Nahuatl
nvh	Nasarian
nvm	Namiae
nvo	Nyokon
nwa	Nawathinehena
nwb	Nyabwa
nwe	Ngwe
nwg	Ngayawung
nwi	Southwest Tanna
nwm	Nyamusa-Molo
nwo	Nauo
nwr	Nawaru
nww	Ndwewe
nwy	Nottoway-Meherrin
nxa	Nauete
nxd	Ngando
nxe	Nage
nxg	Ngad’a
nxi	Nindi
nxk	Kokak Naga
nxl	South Nuaulu
nxn	Ngawun
nxo	Ndambomo
nxq	Naxi
nxr	Ninggerum
nxx	Nafri
nya	Chichewa
nyb	Nyagbo
nyc	Nyanga-li
nyd	Olunyole
nye	Nyengo
nyf	Kigiryama
nyg	Nyindu
nyh	Nyikina
nyi	Ama
nyj	Nyanga
nyk	Nyaneka
nyl	Nyeu
nym	Nyamwezi
nyn	Nyankore
nyo	Nyoro
nyp	Nyang’i
nyq	Nayini
nyr	Malawi Nyiha
nys	Nyungar
nyt	Nyawaygi
nyu	Nyungwe
nyv	Nyulnyul
nyw	Nyaw
nyx	Nganyaywana
nyy	Nyakyusa-Ngonde
nza	Tigon Mbembe
nzb	Njebi
nzd	Nzadi
nzi	Nzema
nzk	Nzakara
nzm	Zeme Naga
nzr	Dir-Nyamzak-Mbarimi
nzs	New Zealand Sign Language
nzu	Teke-Nzikou
nzy	Nzakambay
nzz	Nanga Dama Dogon
oaa	Orok
oac	Oroch
obi	Obispeño
obk	Southern Bontok
obl	Oblo
obo	Obo Manobo
obu	Obulom
oca	Ocaina
oci	Occitan
ocu	Atzingo Matlatzinca
oda	Odut
odk	Oadki
odu	Odual
ofo	Ofo
ofu	Efutop
ogb	Ogbia
ogc	Ogbah
ogg	Ogbogolo
ogo	Khana
ogu	Ogbronuagum
oia	Oirata
oie	Okolie
oin	Inebu One
ojb	Northwestern Ojibwa
ojc	Central Ojibwa
ojg	Eastern Ojibwa
ojs	Oji-Cree
ojv	Ontong Java
ojw	Western Ojibwa
oka	Colville-Okanagan
okb	Okobo
okc	Kobo
okd	Okodia
oke	Okpe
okg	Koko Babangk
okh	Koresh-e Rostam
oki	Okiek
okj	Oko-Juwoi
okk	Kwamtim One
okl	Old Kentish Sign Language
okn	Oki-No-Erabu
okr	Kirike
oks	Oko-Eni-Osayen
oku	Oku
okv	Orokaiva
okx	Okpe
ola	Walungge
old	Mochi
ole	Olekha
olk	Olkol
olm	Oloma
olo	Livvi-Karelian
olr	Olrat
olu	Kuvale
oma	Omaha-Ponca
omb	East Ambae
omc	Mochica
omg	Omagua
omi	Omi
omk	Omok
oml	Ombo
omo	Utarmbung
omt	Omotik
omu	Omurano
omw	South Tairora
ona	Ona
onb	Lingao
one	Oneida
ong	Olo
oni	Onin
onj	Onjob
onk	Kabore One
onn	Onobasulu
ono	Onondaga
onp	Sartang
onr	Northern One
ons	Ono
ont	Ontenu
onu	Unua
onx	Onin Based Pidgin
ood	Tohono O’odham
oog	Ong
oon	Öñge
oor	Oorlams
opa	Okpamheri
opk	Kopkaka
opm	Oksapmin
opo	Opao
opt	Opata
opy	Ofayé
ora	Oroha
orc	Orma
ore	Maijuna
org	Oring
orh	Oroqen
orn	Orang Kanaq
oro	Orokolo
orr	Oruma
ors	Orang Seletar
ort	Adivasi Oriya
oru	Ormuri
orw	Oro Win
orx	Oro
ory	Odia
orz	Ormu
osa	Osage
osi	Osing
oso	Ososo
oss	Ossetic
ost	Osatu
osu	Southern One
otd	Ot Danum
ote	Mezquital Otomi
oti	Oti
otl	Tilapa Otomi
otm	Eastern Highland Otomi
otn	Tenango Otomi
otq	Querétaro Otomi
otr	Otoro
ots	Estado de México Otomí
ott	Temoaya Otomi
otu	Otuke
otw	Ottawa
otx	Texcatepec Otomi
otz	Ixtenco Otomi
oua	Tagargrent
oub	Glio-Oubi
oue	Oune
oum	Ouma
ovd	Övdalian
owi	Owiniga
oyb	Oy
oyd	Oyda
oym	Wayampi
oyy	Oya’oya
ozm	Koonzime
pab	Parecís
pac	Pacoh
pad	Paumarí
pae	Pagibete
paf	Paranawát
pag	Pangasinan
pah	Tenharim
pai	Pye
pak	Parakanã
pam	Kapampangan
pan	Eastern Punjabi
pao	Northern Paiute
pap	Papiamentu
paq	Parya
par	Timbisha
pas	Papasena
pau	Palauan
pav	Pakaásnovos
paw	Pawnee
pax	Pankararé
pay	Pech
paz	Pankararú
pbb	Nasa
pbc	Patamona
pbe	Mezontla Popoloca
pbf	Coyotepec Popoloca
pbg	Paraujano
pbh	E’ñapa Woromaipu
pbi	Parkwa
pbl	Mak
pbm	Puebla and Northeastern Mazatec
pbn	Kpasham
pbo	Papel
pbp	Badyara
pbr	Pangwa
pbs	Central Pame
pbt	Southern Pashto
pbu	Northern Pashto
pbv	Pnar
pby	Pyu
pca	Santa Inés Ahuatempan Popoloca
pcb	Pear
pcc	Giáy
pcd	Picard
pce	Ruching Palaung
pcf	Paliyan
pcg	Paniya
pch	Pardhan
pci	Duruwa
pcj	Parenga
pck	Paite Chin
pcl	Pardhi
pcm	Nigerian Pidgin
pcn	Abishi
pcp	Pacahuara
pcw	Piapung
pda	Anam
pdc	Pennsylvania German
pdi	Pa Di
pdn	Fedan
pdo	Padoe
pdu	Kayan
pea	Peranakan Indonesian
peb	Eastern Pomo
ped	Mala
pee	Taje
pef	Northeastern Pomo
peg	Pengo
peh	Bonan
pei	Chichimeco-Jonaz
pej	Northern Pomo
pek	Penchal
pel	Pekal
pem	Phende
pep	Kanja
peq	Southern Pomo
pes	Iranian Persian
pev	Pémono
pex	Petats
pey	Petjo
pez	Eastern Penan
pfa	Pááfang
pfe	Pere
pfl	Lorraine Franconian
pga	Juba Arabic
pgg	Pangwali
pgi	Pagi
pgk	Rerep
pgs	Pangseng
pgu	Pagu
pgz	Papua New Guinean Sign Language
pha	Pa-Hng
phd	Phudagi
phg	Phuong
phh	Phula
phj	Pahari
phk	Phake
phl	Palula
phm	Phimbi
pho	Phunoi
phq	Phana’
phr	Pahari-Potwari
pht	Phu Thai
phu	Phuan
phv	Pahlavani
phw	Phangduwali
pia	Pima Bajo
pib	Yine
pic	Pinji
pid	Piaroa
pie	Piro
pif	Pingelapese
pig	Pisabo
pih	Pitcairn-Norfolk
pij	Pijao
pil	Yom
pim	Powhatan
pin	Piame
pio	Piapoco
pip	Pero
pir	Piratapuyo
pis	Pijin
pit	Pitta Pitta
piu	Pintupi-Luritja
piv	Vaeakau-Taumako
piw	Pimbwe
pix	Piu
piy	Piya-Kwonci
piz	Pije
pjt	Pitjantjatjara
pkb	Kipfokomu
pkg	Pak-Tong
pkh	Pankhu
pkn	Pakanha
pko	Pökoot
pkp	Pukapuka
pkr	Attapady Kurumba
pks	Pakistan Sign Language
pkt	Maleng
pku	Paku
pla	Miani
plb	Atin
plc	Central Palawano
pld	Polari
ple	Palu’e
plg	Pilagá
plh	Paulohi
pli	Pali
plk	Kohistani Shina
pll	Shwe Palaung
pln	Palenquero
plo	Oluta Popoluca
plr	Palaka Sénoufo
pls	San Marcos Tlacoyalco Popoloca
plt	Merina Malagasy
plu	Palikúr
plv	Southwest Palawano
plw	Brooke’s Point Palawano
ply	Bolyu
plz	Paluan Murut
pma	Paama
pmb	Pambia
pmd	Pallanganmiddang
pme	Pwaamei
pmf	Pamona
pmi	Northern Pumi
pmj	Southern Pumi
pml	Lingua Franca
pmm	Pol
pmn	Pam
pmo	Pom
pmq	Northern Pame
pmr	Manat
pms	Piedmontese
pmt	Tuamotuan
pmw	Plains Miwok
pmx	Poumai Naga
pmy	Papuan Malay
pmz	Southern Pame
pna	Punan Bah-Biau
pnb	Western Punjabi
pnc	Pannei
pnd	Mpinda
pne	Western Penan
png	Pangu
pnh	Penrhyn
pni	Aoheng
pnj	Pinjarup
pnk	Paunaka
pnl	Paleni
pnm	Punan Batu
pnn	Pinai-Hagahai
pno	Panobo
pnp	Pancana
pnq	Pana
pnr	Panim
pns	Ponosakan
pnt	Pontic
pnu	Jiongnai Bunu
pnv	Pinigura
pnw	Banyjima
pnx	Phong-Kniang
pny	Pinyin
pnz	Pana
poc	Poqomam
poe	San Juan Atzingo Popoloca
pof	Poke
pog	Potiguára
poh	Poqomchi’
poi	Highland Popoluca
pok	Pokangá
pol	Polish
pom	Southeastern Pomo
pon	Pohnpeian
poo	Central Pomo
pop	Pwapwâ
poq	Texistepec Popoluca
por	Portuguese
pos	Sayula Popoluca
pot	Potawatomi
pov	Guinea-Bissau Creole
pow	San Felipe Otlaltepec Popoloca
pox	Polabian
poy	Pogolo
ppe	Baiyamo
ppi	Paipai
ppk	Uma
ppl	Nahuat
ppm	Papuma
ppn	Papapana
ppo	Folopa
ppp	Pelende
ppq	Pefiyahe
pps	San Luís Temalacayuca Popoloca
ppt	Pa
ppu	Papora-Hoanya
pqa	Pa’anci
pqm	Malecite-Passamaquoddy
prc	Parachi
prd	Parsi-Dari
pre	Principense
prf	Paranan
prg	Prussian
prh	Porohanon
pri	Paicî
prk	Parauk Wa
prl	Peruvian Sign Language
prm	Kibiri
prn	Prasuni
prq	Perené Ashéninka
prr	Puri
prs	Dari
prt	Prai
pru	Puragi
prw	Parawen
prx	Purig
prz	Providencia Sign Language
psa	Asue Awyu
psc	Iranian Sign Language
psd	Plains Indian Sign Language
pse	Central Malay
psg	Penang Sign Language
psh	Southwest Pashai
psi	Southeast Pashai
psl	Puerto Rican Sign Language
psm	Pauserna
psn	Panasuan
pso	Polish Sign Language
psp	Filipino Sign Language
psq	Pasi
psr	Portuguese Sign Language
pss	Kaulong
pst	Central Pashto
psw	Port Sandwich
psy	Piscataway
pta	Pai Tavytera
pth	Pataxó Hã-Ha-Hãe
pti	Pintiini
ptn	Patani
pto	Zo’é
ptp	Patep
ptq	Pattapu
ptr	Tapiafaru
ptt	Enrekang
ptu	Bambam
ptv	Port Vato
ptw	Pentlatch
pty	Pathiya
pua	Western Highland Purepecha
pub	Purum
puc	Punan Merap
pud	Punan Aput
pue	Puelche
puf	Punan Merah
pug	Phuie
pui	Puinave
puj	Punan Tubu
pum	Puma
puo	Puoc
pup	Pulabu
puq	Puquina
pur	Puruborá
put	Putoh
puu	Punu
puw	Puluwatese
pux	Puare
puy	Purisimeño
pwa	Pawaia
pwb	Panawa
pwg	Gapapaiwa
pwi	Patwin
pwm	Molbog
pwn	Paiwan
pwo	Pwo Western Karen
pwr	Powari
pww	Pwo Northern Karen
pxm	Quetzaltepec Mixe
pye	Pye Krumen
pym	Pyam
pyn	Poyanáwa
pys	Paraguayan Sign Language
pyu	Puyuma
pyy	Pyen
pze	Pesse
pzh	Pazeh
pzn	Jejara Naga
qua	Quapaw
qub	Huallaga Quechua
quc	K’iche’
qud	Calderón Highland Quichua
quf	Lambayeque Quechua
qug	Chimborazo Highland Quichua
quh	South Bolivian Quechua
qui	Quileute
quk	Chachapoyas Quechua
qul	North Bolivian Quechua
qum	Sipakapense
qun	Quinault
qup	Southern Pastaza Quechua
quq	Mercheros
qur	Chaupihuaranga Quechua
qus	Santiago del Estero Quichua
quv	Sakapulteko
quw	Tena Lowland Quichua
qux	Yauyos Quechua
quy	Ayacucho Quechua
quz	Cusco Quechua
qva	Ambo-Pasco Quechua
qvc	Cajamarca Quechua
qve	Eastern Apurímac Quechua
qvh	Huamalíes-Dos de Mayo Quechua
qvi	Imbabura Highland Quichua
qvj	Loja Highland Quichua
qvl	Cajatambo North Lima Quechua
qvm	Margos-Yarowilca-Lauricocha Quechua
qvn	North Junín Quechua
qvo	Napo Quichua
qvp	Pacaraos Quechua
qvs	San Martín Quechua
qvw	Huaylla Wanca Quechua
qvy	Queyu
qvz	Northern Pastaza Quichua
qwa	Corongo Ancash Quechua
qwh	Huaylas Ancash Quechua
qwm	Kuman
qws	Sihuas Ancash Quechua
qwt	Kwalhioqua-Tlatskanai
qxa	Chiquián Quechua
qxc	Chincha Quechua
qxh	Panao Quechua
qxl	Salasaca Highland Quichua
qxn	Northern Conchucos Quechua
qxo	Southern Conchucos Quechua
qxp	Puno Quechua
qxq	Kashkay
qxr	Cañar Highland Quichua
qxs	Southern Qiang
qxt	Santa Ana de Tusi Pasco Quechua
qxu	Arequipa-La Unión Quechua
qxw	Jauja Wanca Quechua
qyp	Quiripi
raa	Dungmali
rab	Chamling
rac	Rasawa
rad	Rade
raf	Western Mewahang
rag	Lulogooli
rah	Rabha
rai	Ramoaaina
rak	Tulu-Bohuai
ral	Ralte
ram	Canela
ran	Riantana
rao	Rao
rap	Rapa Nui
raq	Saam
rar	Cook Islands Maori
ras	Tegali
rat	Razajerdi
rau	Raute
rav	Sampang
raw	Rawang
rax	Rang
ray	Rapa
raz	Rahambuu
rbb	Rumai Palaung
rbk	Northern Bontok
rbl	Miraya Bikol
rbp	Barababaraba
rcf	Réunion French Creole
rdb	Rudbari
rea	Rerau
reb	Rembong
ree	Rejang Kayan
reg	Kara
rei	Reli
rej	Rejang
rel	Rendille
rem	Remo
ren	Rengao
rer	Rer Bare
res	Reshe
ret	Reta
rey	Reyesano
rga	Mores
rge	Romano-Greek
rgk	Rangkas
rgn	Romagnol
rgr	Resígaro
rgs	Southern Roglai
rgu	Rikou
rhg	Rohingya
rhp	Yahang
ria	Riang
rib	Bribri Sign Language
rif	Tarifit
ril	Riang Lang
rim	Nyaturu
rin	Nungu
rir	Ribun
rit	Ritharrngu
riu	Riung
rjg	Rajong
rji	Raji
rjs	Rajbanshi
rka	Kraol
rkb	Rikbaktsa
rkh	Rakahanga-Manihiki
rki	Rakhine
rkm	Marka
rkt	Kamtapuri
rkw	Arakwal
rma	Rama
rmb	Rembarrnga
rmc	Carpathian Romani
rmd	Traveller Danish
rme	Angloromani
rmf	Kalo Finnish Romani
rmg	Traveller Norwegian
rmh	Murkim
rmi	Lomavren
rmk	Romkun
rmm	Roma
rmn	Balkan Romani
rmo	Sinte Romani
rmp	Rempi
rmq	Caló
rms	Romanian Sign Language
rmt	Domari
rmu	Tavringer Romani
rmw	Welsh Romani
rmx	Romam
rmy	Vlax Romani
rmz	Marma
rnb	Brunca Sign Language
rnd	Ruund
rng	Ronga
rnl	Ranglong
rnn	Roon
rnp	Rongpo
rnr	Nari Nari
rnw	Rungwa
rob	Tae’
roc	Cacgia Roglai
rod	Rogo
roe	Uma
rof	Rombo
rog	Northern Roglai
roh	Romansh
rol	Romblomanon
ron	Romanian
roo	Rotokas
rop	Kriol
ror	Rongga
rou	Runga
row	Dela-Oenale
rpn	Repanbitip
rpt	Rapting
rri	Ririo
rrm	Moriori
rro	Waima
rrt	Arritinngithigh
rsb	Romano-Serbian
rsk	Ruthenian
rsl	Russian Sign Language
rsm	Miriwoong Sign Language
rsn	Rwandan Sign Language
rsw	Rishiwa
rtc	Rungtu Chin
rth	Ratahan
rtm	Rotuman
rts	Yurats
rtw	Rathawi
rub	Gungu
ruc	Ruruuli-Runyala
rue	Rusyn
ruf	Luguru
rug	Roviana
ruh	Ruga
rui	Rufiji
ruk	Kuce
run	Rundi
ruo	Istro Romanian
rup	Aromanian
ruq	Megleno Romanian
rus	Russian
rut	Rutul
ruu	Lanas Lobu
ruy	Mala
ruz	Ruma
rwa	Rawo
rwk	Rwa
rwl	Ruwila
rwm	Amba
rwo	Rawa
rwr	Marwari
rxd	Ngardi
rxw	Karuwali
ryn	Northern Amami-Oshima
rys	Yaeyama
ryu	Central Okinawan
rzh	Rāziḥī
saa	Saba
sab	Buglere
sac	Meskwaki
sad	Sandawe
sae	Sabanê
saf	Safaliba
sag	Sango
sah	Yakut
saj	Sahu
sak	Sake
sam	Samaritan Aramaic
san	Sanskrit
sao	Sause
saq	Samburu
sar	Saraveca
sas	Sasak
sat	Santhali
sau	Saleman
sav	Saafi-Saafi
saw	Sawi
sax	Sa
say	Saya
saz	Sourashtra
sba	Ngambay
sbb	Simbo
sbc	Kele
sbd	Southern Samo
sbe	Saliba
sbf	Shabo
sbg	Moi Lemas
sbh	Sori-Harengan
sbi	Seti
sbj	Surbakhal
sbk	Safwa
sbl	Botolan Sambal
sbm	Sagala
sbn	Sindhi Bhil
sbo	Sabüm
sbp	Sangu
sbq	Sirva
sbr	Sembakung Murut
sbs	Kuhane
sbt	Kimki
sbu	Stod Bhoti
sbw	Simba
sbx	Seberuang
sby	Soli
sbz	Sara Kaba
scb	Chut
sce	Dongxiang
scf	San Miguel French Creole
scg	Sanggau
sch	Sakachep
sci	Sri Lankan Malay Creole
sck	Sadri
scl	Shina
scn	Sicilian
sco	Scots
scp	Hyolmo
scq	Chung
scs	North Slavey
sct	Southern Katang
scu	Shumcho
scv	Sheni
scw	Sya
sda	Toraja-Sa’dan
sdb	Shabak
sdc	Sassarese Sardinian
sde	Vori
sdf	Sarli
sdg	Savi
sdh	Southern Kurdish
sdj	Suundi
sdk	Sos Kundi
sdl	Saudi Arabian Sign Language
sdn	Gallurese Sardinian
sdo	Bidayuh Serian
sdp	Sherdukpen
sdq	Semandang
sdr	Oraon Sadri
sds	Sened
sdt	Shuadit
sdu	Sarudu
sdx	Sibu Melanau
sdz	Sallands
sea	Semai
seb	Shempire Sénoufo
sec	Sechelt
sed	Sedang
see	Seneca
sef	Cebaara Sénoufo
seg	Segeju
seh	Sena
sei	Seri
sej	Sene
sek	Sekani
sel	Selkup
sen	Nanerigé Sénoufo
seo	Asaba
sep	Sìcìté Sénoufo
seq	Senara Sénoufo
ser	Serrano
ses	Koyraboro Senni Songhay
set	Sentani
seu	Serui-Laut
sev	Nyarafolo Sénoufo
sew	Sewa Bay
sey	Secoya
sez	Senthang Chin
sfb	French Belgian Sign Language
sfe	Eastern Subanen
sfm	Small Flowery Miao
sfs	South African Sign Language
sfw	Esahie
sgb	Mag-antsi Ayta
sgc	Kipsigis
sgd	Surigaonon
sge	Segai
sgg	Swiss-German Sign Language
sgh	Shughni
sgi	Nizaa
sgj	Surgujia
sgk	Sangkong
sgm	Singa
sgp	Singpho
sgr	Sangisari
sgs	Samogitian
sgt	Brokpake
sgu	Salas
sgw	Sebat Bet Gurage
sgx	Sierra Leone Sign Language
sgy	Sanglechi
sgz	Sursurunga
sha	Shall-Zwall
shb	Ninam
shc	Sonde
shd	Kundal Shahi
she	Sheko
shg	Shua
shh	Shoshoni
shi	Tachelhit
shj	Shatt
shk	Shilluk
shl	Shendu
shm	Shahrudi
shn	Shan
sho	Shanga
shp	Shipibo-Conibo
shq	Sala
shr	Shi
shs	Shuswap
sht	Shasta
shu	Chadian Arabic
shv	Shehri
shw	Shwai
shx	She
shy	Tachawit
shz	Syenara Sénoufo
sia	Akkala Saami
sib	Sebop
sid	Sidamo
sie	Simaa
sif	Siamou
sig	Paasaal
sih	Sîshëë
sii	Shom Peng
sij	Numbami
sik	Sikiana
sil	Tumulung Sisaala
sim	Mende
sin	Sinhala
sip	Sikkimese
siq	Sonia
sir	Siri
sis	Siuslaw
siu	Sinagen
siv	Sumariup
siw	Motuna
six	Sumau
siy	Sivandi
siz	Siwi
sja	Epena
sjb	Sajau Basap
sjd	Kildin Saami
sje	Pite Saami
sjg	Assangori
sjk	Kemi Saami
sjl	Miji
sjm	Mapun
sjo	Xibe
sjp	Surjapuri
sjr	Siar-Lak
sjs	Senhaja Berber
sjt	Ter Saami
sju	Ume Saami
sjw	Shawnee
ska	Skagit
skb	Saek
skc	Ma Manda
skd	Southern Sierra Miwok
ske	Ske
skf	Sakirabiá
skg	Sakalava Malagasy
skh	Sikule
ski	Sika
skj	Seke
skm	Kutong
skn	Kolibugan Subanon
sko	Seko Tengah
skp	Sekapan
skq	Sininkere
skr	Saraiki
sks	Maia
skt	Sakata
sku	N’kep
skv	Skou
skw	Skepi Dutch Creole
skx	Seko Padang
sky	Sikaiana
skz	Sekar
slc	Sáliba
sld	Sissala
sle	Sholaga
slf	Swiss-Italian Sign Language
slg	Selungai Murut
slh	Southern Lushootseed
sli	Lower Silesian
slj	Salumá
slk	Slovak
sll	Yui
slm	Pangutaran Sama
sln	Salinan
slp	Lamaholot
slr	Salar
sls	Singapore Sign Language
slt	Sila
slu	Selaru
slv	Slovene
slw	Sialum
slx	Salampasu
sly	Selayar
slz	Ma’ya
sma	South Saami
smb	Simbari
smc	Tayatuk
sme	North Saami
smf	Auwe
smg	Simbali
smh	Samei
smj	Lule Saami
smk	Bolinao
sml	Central Sama
smm	Musasa
smn	Inari Saami
smo	Samoan
smp	Samaritan Hebrew
smq	Samo
smr	Simeulue
sms	Skolt Saami
smt	Simte
smu	Somray
smv	Samvedi
smw	Sumbawa
smx	Samba
smy	Semnani
smz	Simeku
sna	Shona
snc	Sinaugoro
snd	Sindhi
sne	Bau Bidayuh
snf	Noon
sng	Sanga
sni	Sensi
snj	Riverain Sango
snk	Soninke
snl	Sangil
snm	Southern Ma’di
snn	Siona
sno	Snohomish
snp	Siane
snq	Sangu
snr	Sihan
sns	Nahavaq
snu	Viid
snv	Sa’ban
snw	Selee
snx	Sam
sny	Saniyo-Hiyewe
snz	Kou
soa	Thai Song
sob	Sobei
soc	So
sod	Songoora
soe	Ohendo
soh	Aka
soi	Sonha
soj	Soi
sok	Sokoro
sol	Solos
som	Somali
soo	Songo
sop	Songe
soq	Kanasi
sor	Soumraye
sos	Seenku
sot	Southern Sotho
sou	Southern Thai
sov	Sonsorolese
sow	Sowanda
sox	Swo
soy	Miyobe
soz	Temi
spa	Spanish
spb	Sepa
spc	Sapé
spd	Saep
spe	Sepa
spg	Sihan
spi	Saponi
spk	Sengo
spl	Selepet
spm	Akukem
spn	Sanapaná
spo	Spokane
spp	Supyire Sénoufo
spq	Charapa Spanish
spr	Saparua
sps	Saposa
spt	Spiti Bhoti
spu	Sapuan
spv	Sambalpuri
spy	Sabaot
sqa	Shama-Sambuga
sqh	Shau
sqk	Albanian Sign Language
sqm	Suma
sqn	Susquehannock
sqo	Sorkhei
sqq	Sou
sqs	Sri Lankan Sign Language
sqt	Soqotri
squ	Squamish
sqx	Kufr Qassem Sign Language
sra	Saruga
srb	Sora
src	Logudorese Sardinian
sre	Sara Bakati’
srf	Nafi
srg	Sulod
srh	Sarikoli
sri	Siriano
srk	Serudung Murut
srl	Isirawa
srm	Saramaccan
srn	Sranan Tongo
sro	Campidanese Sardinian
srp	Serbian
srq	Sirionó
srr	Serer-Sine
srs	Sarsi
srt	Sauri
sru	Suruí
srv	Southern Sorsoganon
srw	Serua
srx	Sirmauri
sry	Sera
srz	Shahmirzadi
ssb	Southern Sama
ssc	Suba-Simbiti
ssd	Siroi
sse	Balangingih Sama
ssf	Thao
ssg	Seimat
ssh	Shihhi Arabic
ssi	Sansi
ssj	Wia
ssk	Sunam
ssl	Western Sisaala
ssm	Semnam
ssn	Waata
sso	Essono
ssp	Spanish Sign Language
ssq	So’a
ssr	Swiss-French Sign Language
sss	So
sst	Sinasina
ssu	Susuami
ssv	Ngen
ssw	Swati
ssx	Samberigi
ssy	Saho
ssz	Sengseng
sta	Settla
stb	Northern Subanen
std	Sentinel
ste	Liana-Seti
stf	Seta
stg	Trieng
sth	Shelta
sti	Bulo Stieng
stj	Matya Samo
stk	Aramba
stl	Stellingwerfs
stm	Setaman
stn	Owa
sto	Stoney
stp	Southeastern Tepehuan
stq	Saterfriesisch
str	Northern Straits Salish
sts	Shumashti
stt	Budeh Stieng
stu	Samtao
stv	Silt’e
stw	Satawalese
sty	Siberian Tatar
sua	Sulka
sub	Suku
suc	Western Subanon
sue	Suena
sug	Suganga
sui	Suki
suj	Shubi
suk	Sukuma
sun	Sunda
suo	Bouni
suq	Tirmaga-Chai Suri
sur	Mwaghavul
sus	Susu
sut	Subtiaba
suv	Puroik
suw	Sumbwa
suy	Suyá
suz	Sunwar
sva	Svan
svb	Ulau-Suain
svc	Vincentian English Creole
sve	Serili
svk	Slovakian Sign Language
svm	Slavomolisano
svs	Savosavo
swb	Maore Comorian
swc	Congo Swahili
swe	Swedish
swf	Sere
swg	Swabian
swh	Swahili
swi	Sui
swj	Sira
swk	Malawi Sena
swl	Swedish Sign Language
swm	Samosa
swn	Sawknah
swo	Shanenawa
swp	Suau
swq	Sharwa
swr	Saweru
sws	Seluwasan
swt	Sawila
swu	Suwawa
swv	Shekhawati
sww	Sowa
swx	Suruahá
swy	Sarua
sxb	Suba
sxe	Sighu
sxg	Shuhi
sxk	Southern Kalapuya
sxm	Samre
sxn	Sangir
sxr	Saaroa
sxs	Sasaru
sxu	Upper Saxon
sxw	Saxwe Gbe
sya	Siang
syb	Central Subanen
syc	Syriac
syi	Seki
syk	Sukur
syl	Sylheti
sym	Maya Samo
syn	Senaya
syo	Su’ung
sys	Sinyar
syw	Syuba
syx	Samay
syy	Al-Sayyid Bedouin Sign Language
sza	Semelai
szb	Ngalum
szc	Semaq Beri
sze	Seze
szg	Sengele
szl	Silesian
szn	Sula
szp	Suabo
szs	Solomon Islands Sign Language
szv	Isubu
szw	Sawai
szy	Sakizaya
taa	Lower Tanana
tab	Tabasaran
tac	Western Tarahumara
tad	Tause
tae	Tariana
taf	Tapirapé
tag	Tagoi
tah	Tahitian
taj	Eastern Tamang
tak	Tala
tal	Tal
tam	Tamil
tan	Tangale
tao	Yami
tap	Taabwa
taq	Tamasheq
tar	Central Tarahumara
tas	Tay Boi
tat	Tatar
tau	Upper Tanana
tav	Tatuyo
taw	Tay
tax	Tamki
tay	Atayal
taz	Tocho
tba	Aikanã
tbc	Takia
tbd	Kaki Ae
tbe	Tanibili
tbf	Mandara
tbg	North Tairora
tbh	Dharawal
tbi	Gaam
tbj	Tiang
tbk	Calamian Tagbanwa
tbl	Tboli
tbm	Tagbu
tbn	Barro Negro Tunebo
tbo	Tawala
tbp	Taburta
tbr	Tumtum
tbs	Tanguat
tbt	Tembo
tbu	Tubar
tbv	Tobo
tbw	Tagbanwa
tbx	Kapin
tby	Tabaru
tbz	Ditammari
tca	Ticuna
tcb	Tanacross
tcc	Datooga
tcd	Tafi
tce	Southern Tutchone
tcf	Malinaltepec Me’phaa
tcg	Tamagario
tch	Turks and Caicos English Creole
tci	Wára
tck	Tchitchege
tcl	Taman
tcm	Tanahmerah
tcn	Tichurong
tco	Taungyo
tcp	Tawr Chin
tcq	Kaiy
tcs	Torres Strait Creole
tct	T’en
tcu	Southeastern Tarahumara
tcw	Tecpatlán Totonac
tcx	Toda
tcy	Tulu
tcz	Thado Chin
tda	Tagdal
tdb	Panchpargania
tdc	Embera Tadó
tdd	Tai Nüa
tde	Tiranige Diga Dogon
tdf	Talieng
tdg	Western Tamang
tdh	Thulung
tdi	Tomadino
tdj	Tajio
tdk	Rom
tdl	Kusur-Myet
tdm	Taruma
tdn	Tondano
tdo	Teme
tdq	Tita
tdr	Todrah
tds	Doutai
tdt	Tetun Dili
tdv	Atoro
tdx	Tandroy-Mahafaly Malagasy
tdy	Tadyawan
tea	Temiar
teb	Tetete
tec	Terik
ted	Tepo Krumen
tee	Huehuetla Tepehua
tef	Teressa
teg	Teke-Tege
teh	Tehuelche
tei	Aro
tek	Teke-Ibali
tel	Telugu
tem	Themne
ten	Tama
teo	Ateso
tep	Tepecano
teq	Temein
ter	Terêna
tes	Tengger
tet	Tetun
teu	Soo
tev	Teor
tew	Tewa
tex	Tennet
tey	Tulishi
tez	Tetserret
tfi	Tofin Gbe
tfn	Tanaina
tfo	Tefaro
tfr	Teribe
tft	Ternate
tga	Sagalla
tgb	Tobilung
tgc	Tigak
tgd	Choogen
tge	Eastern Gorkha Tamang
tgf	Chalikha
tgh	Tobagonian English Creole
tgi	Lawunuia
tgj	Tagin
tgk	Tajik
tgl	Tagalog
tgn	Tandaganon
tgo	Sudest
tgp	Tangoa
tgq	Tring
tgr	Tareng
tgs	Nume
tgt	Central Tagbanwa
tgu	Tanggu
tgv	Tingui-Boto
tgw	Tagwana Sénoufo
tgx	Tagish
tgy	Togoyo
tgz	Tagalaka
tha	Thai
thd	Kuuk Thayorre
the	Central Tharu
thf	Thangmi
thh	Northern Tarahumara
thi	Tai Long
thk	Kitharaka
thl	Dangaura Tharu
thm	Aheu
thn	Thachanadan
thp	Thompson
thq	Mid-Eastern Tharu
thr	Rana Tharu
ths	Thakali
tht	Tahltan
thu	Thuri
thv	Tahaggart Tamahaq
thy	Tha
thz	Tayart Tamajeq
tia	Tidikelt Tamazight
tic	Tira
tif	Tifal
tig	Tigré
tih	Timugon Murut
tii	Tiene
tij	Tilung
tik	Tikar
til	Tillamook
tim	Timbe
tin	Tindi
tio	Teop
tip	Trimuris
tiq	Tiéfo
tir	Tigrigna
tis	Masadiit Itneg
tit	Tinigua
tiu	Adasen
tiv	Tiv
tiw	Tiwi
tix	Southern Tiwa
tiy	Teduray
tiz	Tai Hongjin
tja	Tajuasohn
tjg	Tunjung
tji	Northern Tujia
tjj	Tjungundji
tjl	Tai Laing
tjm	Timucua
tjn	Tonjon
tjo	Temacine Tamazight
tjp	Tjupany
tjs	Southern Tujia
tju	Tjurruru
tjw	Djabwurrung
tka	Truká
tkb	Buksa
tkd	Tukudede
tke	Takwane
tkf	Tukumanféd
tkg	Tesaka Malagasy
tkl	Tokelauan
tkm	Takelma
tkn	Toku-No-Shima
tkp	Tikopia
tkq	Tèẹ̀ ̣
tkr	Tsakhur
tks	Takestani
tkt	Kathariya Tharu
tku	Upper Necaxa Totonac
tkv	Mur Pano
tkw	Teanu
tkx	Tangko
tkz	Takua
tla	Southwestern Tepehuan
tlb	Tobelo
tlc	Yecuatla Totonac
tld	Talaud
tlf	Telefol
tlg	Tofanma
tli	Tlingit
tlj	Talinga-Bwisi
tlk	Taloki
tll	Tetela
tlm	Tolomako
tln	Talondo’
tlo	Talodi
tlp	Filomena Mata-Coahuitlán Totonac
tlq	Tai Loi
tlr	Talise
tls	Tambotalo
tlt	Sou Nama
tlu	Tulehu
tlv	Taliabu
tlx	Khehek
tly	Talysh
tma	Tama
tmb	Avava
tmc	Tumak
tmd	Haruai
tme	Tremembé
tmf	Toba-Maskoy
tmg	Ternateño
tmi	Vinekula
tmj	Samarokena
tml	Tamnim Citak
tmm	Tai Thanh
tmn	Taman
tmo	Temoq
tmq	Tumleo
tmr	Jewish Babylonian Aramaic
tms	Tima
tmt	Oa
tmu	Iau
tmv	Tembo
tmw	Temuan
tmy	Tami
tmz	Tamanaku
tna	Tacana
tnb	Western Tunebo
tnc	Tanimuca-Letuama
tnd	Angosturas Tunebo
tng	Tobanga
tnh	Maiani
tni	Tandia
tnk	Kwamera
tnl	Lenakel
tnm	Tabla
tnn	North Tanna
tno	Toromono
tnp	Whitesands
tnq	Taíno
tnr	Ménik
tns	Tenis
tnt	Tontemboan
tnu	Tai Khang
tnv	Tangchangya
tnw	Tonsawang
tnx	Tanema
tny	Tongwe
tnz	Ten’edn
tob	Toba Qom
toc	Coyutla Totonac
tod	Toma
tof	Gizrra
tog	Tonga
toh	Tonga
toi	Tonga
toj	Tojolabal
tol	Tolowa
tom	Tombulu
ton	Tongan
too	Xicotepec de Juárez Totonac
top	Papantla Totonac
toq	Toposa
tor	Togbo-Vara Banda
tos	Highland Totonac
tou	Tho
tov	Upper Taromi
tow	Jemez
tox	Tobian
toy	Topoiyo
toz	To
tpa	Taupota
tpc	Azoyú Me’phaa
tpe	Tippera
tpf	Tarpia
tpg	Kula
tpi	Tok Pisin
tpj	Ñandeva
tpk	Tupinikin
tpl	Tlacoapa Me’phaa
tpm	Tampulma
tpn	Tupinambá
tpo	Tai Pao
tpp	Pisaflores Tepehua
tpq	Chhoyul Kinnauri
tpr	Tuparí
tpt	Tlachichilco Tepehua
tpu	Tampuan
tpv	Tanapag
tpx	Acatepec Me’phaa
tpy	Trumai
tpz	Tinputz
tqb	Tembé
tql	Lehali
tqm	Turumsa
tqn	Tenino
tqo	Toaripi
tqp	Tomoip
tqq	Tunni
tqr	Torona
tqt	Totonaco del cerro Xinolatépetl
tqu	Touo
tqw	Tonkawa
tra	Tirahi
trb	Terebu
trc	Copala Triqui
trd	Turi
tre	East Tarangan
trf	Trinidadian English Creole
trg	Lishán Noshan
trh	Turaka
tri	Trió
trj	Toram
trl	Traveller Scottish
trm	Tregami
trn	Trinitario
tro	Tarao Naga
trp	Kok Borok
trq	San Martín Itunyoso Triqui
trr	Taushiro
trs	Chicahuaxtla Triqui
trt	Tunggare
tru	Turoyo
true	Nyankpa
trv	Sediq
trw	Torwali
trx	Tringgus-Sembaan Bidayuh
try	Turung
trz	Torá
tsa	Tsaangi
tsb	Tsamai
tsc	Tswa
tsd	Tsakonian
tse	Tunisian Sign Language
tsg	Tausug
tsh	Tsuvan
tsi	Tsimshian
tsj	Tshangla
tsk	Tseku
tsl	Ts’ün-Lao
tsm	Turkish Sign Language
tsn	Setswana
tso	Tsonga
tsp	Northern Toussian
tsq	Thai Sign Language
tsr	Akei
tss	Taiwan Sign Language
tst	Tondi Songway Kiini
tsu	Tsou
tsv	Tsogo
tsw	Tsishingini
tsx	Mubami
tsy	Tebul Sign Language
tsz	Purepecha
tta	Tutelo
ttb	Gaa
ttc	Tectitec
ttd	Tauade
tte	Bwanabwana
ttf	Tuotomb
ttg	Tutong
tth	Upper Ta’oih
tti	Tobati
ttj	Tooro
ttk	Totoro
ttl	Totela
ttm	Northern Tutchone
ttn	Towei
tto	Lower Ta’oih
ttp	Tombelala
ttq	Tawallammat Tamajaq
ttr	Tera
tts	Northeastern Thai
ttt	Muslim Tat
ttu	Torau
ttv	Titan
ttw	Long Wat
tty	Sikaritai
ttz	Tsum
tua	Wiarumus
tub	Tübatulabal
tuc	Mutu
tud	Tuxá
tue	Tuyuca
tuf	Central Tunebo
tug	Tunia
tuh	Tulil
tui	Tupuri
tuj	Tugutil
tuk	Turkmen
tul	Tula
tum	Tumbuka
tun	Tunica
tuo	Tucano
tuq	Tedaga
tur	Turkish
tus	Tuscarora
tuu	Tututni
tuv	Turkana
tux	Tuxináwa
tuy	Tugen
tuz	Turka
tva	Vaghua
tvd	Tsuvadi
tve	Te’un
tvi	Tulai
tvk	Southeast Ambrym
tvl	Tuvaluan
tvm	Tela-Masbuar
tvn	Tavoyan
tvo	Tidore
tvs	Taveta
tvt	Tutsa Naga
tvu	Tunen
tvw	Sedoa
tvx	Taivoan
tvy	Timor Pidgin
twa	Twana
twb	Tawbuid
twc	Teshenawa
twd	Twents
twe	Teiwa
twf	Northern Tiwa
twg	Tereweng
twh	Tai Dón
twl	Tawara
twm	Tawang Monpa
twn	Twendi
two	Tswapong
twp	Ere
twq	Tasawaq
twr	Southwestern Tarahumara
twt	Turiwára
twu	Termanu
tww	Tuwari
twx	Tewe
twy	Tawoyan
txa	Tombonuo
txc	Tsetsaut
txe	Totoli
txi	Ikpeng
txj	Tarjumo
txm	Tomini
txn	West Tarangan
txo	Toto
txq	Tii
txs	Tonsea
txt	Citak
txu	Kayapó
txx	Tatana
txy	Tanosy Malagasy
tya	Tauya
tye	Kyanga
tyh	O’du
tyi	Teke-Tsaayi
tyj	Tai Yo
tyl	Thu Lao
tyn	Kombai
typ	Thaypan
tyr	Tai Daeng
tys	Tày Sa Pa
tyt	Tày Tac
tyu	Kua
tyv	Tuvan
tyx	Teke-Tyee
tyy	Tiyaa
tyz	Tày
tza	Tanzanian Sign Language
tzh	Tzeltal
tzj	Tz’utujil
tzm	Central Atlas Tamazight
tzn	Tugun
tzo	Tzotzil
tzx	Karawari
uam	Uamué
uan	Kuan
uar	Tairuma
uba	Ubang
ubi	Ubi
ubl	Buhi’non Bikol
ubr	Ubir
ubu	Umbu-Ungu
uby	Ubykh
uda	Uda
ude	Udihe
udg	Muduga
udi	Udi
udj	Ujir
udl	Wuzlam
udm	Udmurt
udu	Uduk
ues	Kioko
ufi	Ufim
ugb	Kuku-Ugbanh
uge	Ughele
ugh	Kubachi
ugn	Ugandan Sign Language
ugo	Ugong
ugy	Uruguayan Sign Language
uha	Uhami
uhn	Damal
uig	Uyghur
uis	Uisai
uiv	Iyive
uji	Rjili
uka	Kaburi
ukg	Ukuriguma
ukh	Ukhwejo
uki	Kui
ukk	Muak Sa-aak
ukl	Ukrainian Sign Language
ukp	Bukpe
ukq	Ukwa
ukr	Ukrainian
uks	Kaapor Sign Language
uku	Ukue
ukv	Kuku
ukw	Ukwuani-Aboh-Ndoni
uky	Kuuk-Yak
ula	Fungwa
ulb	Ulukwumi
ulc	Ulch
ule	Lule
ulf	Usku
uli	Ulithian
ulk	Meriam Mir
ull	Ullatan
ulm	Ulumanda’
uln	Unserdeutsch
ulu	Uma’ Lung
ulw	Ulwa
uly	Buli
uma	Umatilla
umb	Umbundu
umd	Umbindhamu
umg	Morrobalama
umi	Ukit
umm	Umon
umn	Paungnyuan Naga
umo	Umotína
ump	Umpila
umr	Umbugarla
ums	Pendau
umu	Munsee
una	North Kodut
une	Uneme
ung	Ngarinyin
uni	Uni
unk	Enawené-Nawé
unm	Unami
unn	Kurnai
unr	Mundari
unu	Unubahe
unx	Munda
unz	Unde Kaili
uon	Kulon
upi	Umeda
upv	Uripiv-Wala-Rano-Atchin
ura	Urarina
urb	Kaapor
urc	Urningangg
urd	Urdu
ure	Uru
urf	Uradhi
urg	Kobuka
urh	Urhobo
uri	Urim
urk	Urak Lawoi’
url	Urali
urm	Urapmin
urn	Uruangnirin
uro	Ura
urp	Uru-Pa-In
urr	Löyöp
urt	Urat
uru	Urumi
urv	Uruava
urw	Sob
urx	Urimo
ury	Orya
urz	Uru-Eu-Wau-Wau
usa	Usarufa
ush	Ushojo
usi	Usoi
usk	Usaghade
usp	Uspanteko
uss	us-Saare
usu	Uya
uta	Itang
ute	Ute-Southern Paiute
uth	ut-Hun
utp	Amba
utr	Etulo
utu	Utu
uum	Urum
uur	Ura
uuu	U
uve	Fagauvea
uvh	Uri
uvl	Lote
uwa	Kuku-Uwanh
uya	Deko-Dusanga
uzn	Northern Uzbek
uzs	Southern Uzbek
vaa	Vaagri Booli
vae	Vale
vaf	Vafsi
vag	Vagla
vah	Varhadi-Nagpuri
vai	Vai
vaj	Northwestern !Kung
val	Vehes
vam	Dumo
van	Walman
vao	Vao
vap	Vaiphei
var	Huarijío
vas	Vasavi
vau	Vanuma
vav	Varli
vay	Wayu
vbb	Southeast Babar
vbk	Southwestern Bontok
vec	Venetian
ved	Veddah
vel	Veluws
vem	Vemgo-Mabas
ven	Venda
veo	Ventureño
vep	Veps
ver	Verre
vgr	Vaghri
vgt	Flemish Sign Language
vic	Virgin Islands English Creole
vid	Vidunda
vie	Vietnamese
vif	Vili
vig	Viemo
vil	Vilela
vis	Vishavan
vit	Viti
viv	Iduna
vjk	Bajjika
vka	Kariyarra
vkj	Kujarge
vkk	Kaur
vkl	Kulisusu
vkm	Kamakan
vkn	Koro Nulu
vko	Kodeoha
vkp	Korlai Portuguese Creole
vkt	Tenggarong Kutai Malay
vku	Kurrama
vkz	Koro Zuba
vlp	Tavanlav
vls	West Flemish
vma	Martuyhunira
vmb	Barbaram
vmc	Juxtlahuaca Mixtec
vmd	Mudu Koraga
vme	East Masela
vmf	Eastern Franconian
vmg	Vinitiri
vmh	Maraghei
vmi	Miwa
vmj	Ixtayutla Mixtec
vmk	Makhuwa-Shirima
vml	Malgana
vmm	Mitlatongo Mixtec
vmp	Soyaltepec Mazatec
vmq	Soyaltepec Mixtec
vmr	Marenje
vms	Moksela
vmu	Muluridyi
vmv	Valley Maidu
vmw	Makhuwa
vmx	Tamazola Mixtec
vmy	Ayautla Mazatec
vmz	Mazatlán Mazatec
vnk	Lovono
vnm	Neve’ei
vnp	Tapesena
vor	Voro
vot	Vod
vra	Vera’a
vro	Seto
vrs	Varisi
vrt	Banam Bay
vsi	Moldova Sign Language
vsl	Venezuelan Sign Language
vsv	Valencian Sign Language
vto	Vitou
vum	Vumbu
vun	Vunjo
vut	Vute
vwa	Awa
waa	Walla Walla
wab	Yote
wac	Wasco-Wishram
wad	Wamesa
wae	Walser
waf	Wakoná
wag	Wa’ema
wah	Watubela
wai	Wares
waj	Waffa
wal	Wolaytta
wam	Wampanoag
wan	Wan
wao	Wappo
wap	Wapishana
waq	Wagiman
war	Waray-Waray
was	Washo
wat	Kaninuwa
wau	Waurá
wav	Waka
waw	Waiwai
wax	Marangis
way	Wayana
waz	Wampur
wba	Warao
wbb	Wabo
wbe	Waritai
wbf	Wara
wbh	Wanda
wbi	Vwanji
wbj	Alagwa
wbk	Waigali
wbl	Wakhi
wbm	Vo Wa
wbp	Warlpiri
wbq	Waddar
wbr	Wagdi
wbs	West Bengal Sign Language
wbt	Warnman
wbv	Wajarri
wbw	Woi
wca	Yanomámi
wci	Waci Gbe
wdd	Wandji
wdg	Wadaginam
wdj	Wadjiginy
wdk	Wadikali
wdt	Wendat
wdu	Wadjigu
wdy	Wadjabangayi
wea	Wewaw
wec	Wè Western
wed	Wedau
weg	Wergaia
weh	Weh
wei	Kiunum
wem	Weme Gbe
weo	Wemale
wep	Westphalien
wer	Amam
wes	Cameroon Pidgin
wet	Perai
weu	Rawngtu Chin
wew	Wejewa
wfg	Zorop
wga	Wagaya
wgb	Wagawaga
wgg	Wangkangurru
wgi	Wahgi
wgo	Ambel
wgu	Wirangu
wgy	Warrgamay
wha	Sou Upaa
whg	Yuwei
whk	Wahau Kenyah
whu	Wahau Kayan
wib	Southern Toussian
wic	Wichita
wie	Wik-Epa
wif	Wik-Keyangan
wig	Wik Ngathan
wih	Wik-Me’anha
wii	Minidien
wij	Wik-Iiyanh
wik	Wikalkan
wil	Wilawila
wim	Wik-Mungkan
win	Ho-Chunk
wir	Wiraféd
wiu	Witu
wiv	Vitu
wiy	Wiyot
wja	Waja
wji	Warji
wka	Kw’adza
wkb	Kumbaran
wkd	Mo
wkl	Kalanadi
wkr	Keerray-Woorroong
wku	Kunduvadi
wkw	Wakawaka
wky	Wangkayutyuru
wla	Walio
wlc	Mwali Comorian
wle	Wolane
wlg	Kunbarlang
wlh	Welaun
wli	Waioli
wlk	Wailaki
wll	Wali
wln	Walloon
wlo	Wolio
wlr	Moiso
wls	Wallisian
wlu	Wuliwuli
wlv	Bermejo Wichí
wlw	Walak
wlx	Wali
wmb	Wambaya
wmc	Wamas
wmd	Mamaindê
wme	Wambule
wmg	Western Minyag
wmh	Waima’a
wmi	Wamin
wmm	Maiwa
wmn	Waamwang
wmo	Wom
wms	Wambon
wmt	Walmajarri
wmw	Mwani
wmx	Pin
wnb	Mokati
wnc	Wantoat
wnd	Wandarang
wne	Waneci
wng	Wanggom
wni	Ndzwani Comorian
wnk	Wanukaka
wnm	Wanggamala
wnn	Wunumara
wno	Wano
wnp	Wanap
wnu	Usan
wnw	Wintu
wny	Waanyi
woa	Kuwema
wob	Wè Northern
woc	Wogeo
wod	Wolani
woe	Woleaian
wof	Gambian Wolof
wog	Wogamusin
woi	Kamang
wok	Longto
wol	Wolof
wom	Wom
won	Wongo
woo	Manombai
wor	Woria
wos	Hanga Hundi
wow	Wawonii
woy	Weyto
wpc	Maco
wrb	Waluwarra
wrg	Warungu
wrh	Wiradjuri
wri	Wariyangga
wrk	Garrwa
wrl	Warlmanpa
wrm	Warumungu
wrn	Warnang
wro	Worrorra
wrp	Waropen
wrr	Wardaman
wrs	Waris
wru	Waru
wrv	Waruna
wrw	Gugu Warra
wrx	Wae Rana
wry	Merwari
wrz	Waray
wsa	Warembori
wsg	Adilabad Gondi
wsi	Jo
wsk	Waskia
wsr	Owenia
wss	Wasa
wsu	Wasu
wsv	Degano
wtb	Matambwe
wtf	Watiwa
wth	Wathawurrung
wti	Berta
wtk	Watakataui
wtm	Mewati
wtw	Wotu
wua	Wikngenchera
wub	Wunambal
wud	Wudu
wuh	Wutunhua
wul	Silimo
wum	Wumbvu
wun	Bungu
wut	Wutung
wuu	Wu Chinese
wuv	Wuvulu-Aua
wux	Wulna
wuy	Wauyai
wwa	Waama
wwb	Wakabunga
wwo	Dorig
wwr	Warrwa
www	Wawa
wxa	Waxianghua
wxw	Wardandi
wyb	Wangaaybuwan-Ngiyambaa
wyi	Woiwurrung
wym	Wymysorys
wyn	Wyandot
wyr	Wayoró
wyy	Western Fijian
xab	Sambe
xac	Kachari
xad	Adai
xai	Kaimbé
xaj	Ararandewára
xak	Máku
xal	Kalmyk-Oirat
xam	ǀXam
xan	Xamtanga
xao	Khao
xap	Apalachee
xar	Karami
xas	Kamas
xat	Katawixi
xau	Kauwera
xav	Xavánte
xaw	Kawaiisu
xay	Kayan Mahakam
xbb	Lower Burdekin
xbd	Bindal
xbe	Bigambal
xbg	Bunganditj
xbi	Kombio
xbj	Birrpayi
xbn	Kenaboi
xbp	Bibbulman
xbr	Kambera
xbw	Kambiwá
xby	Batjala
xch	Chemakum
xcm	Comecrudo
xcn	Cotoname
xcv	Chuvantsy
xcw	Coahuilteco
xcy	Cayuse
xda	Darkinyung
xdk	Dharuk
xdo	Kwandu
xdq	Kaitag
xdy	Malayic Dayak
xed	Hide
xeg	ǁXegwi
xel	Kelo
xem	Mateq
xer	Xerénte
xes	Koromu
xet	Xetá
xeu	Keoru-Ahia
xgb	Gbin
xgd	Gudang
xgf	Gabrielino-Fernandeño
xgg	Goreng
xgi	Garingbal
xgm	Dharumbal
xgr	Garza
xgu	Unggumi
xgw	Guwa
xhe	Khetrani
xho	Xhosa
xhv	Khua
xii	Xiri
xin	Xinca
xir	Xiriâna
xis	Kisan
xiy	Xipaya
xjb	Minjungbal
xjt	Jaitmatang
xka	Kalkoti
xkb	Northern Nago
xkc	Kho’ini
xkd	Mendalam Kayan
xke	Kereho
xkf	Khengkha
xkg	Kagoro
xki	Kenyan Sign Language
xkj	Kajali
xkk	Kachok
xkl	Mainstream Kenyah
xkn	Kayan River Kayan
xko	Kiorr
xkp	Kabatei
xkq	Koroni
xkr	Xakriabá
xks	Kumbewaha
xkt	Kantosi
xku	Kaamba
xkv	Kgalagadi
xkw	Kembra
xkx	Karore
xky	Uma’ Lasan
xkz	Kurtokha
xla	Kamula
xlb	Loup B
xlo	Loup A
xma	Mushungulu
xmb	Mbonga
xmc	Makhuwa-Marrevone
xmd	Mbudum
xmf	Mingrelian
xmg	Mengaka
xmh	Kugu-Muminh
xmj	Majera
xml	Malaysian Sign Language
xmm	Manado Malay
xmo	Morerebi
xmp	Kuku-Mu’inh
xmq	Kuku-Mangk
xms	Moroccan Sign Language
xmt	Matbat
xmu	Kamu
xmv	Antankarana Malagasy
xmw	Tsimihety Malagasy
xmx	Salawati
xmy	Mayaguduna
xmz	Mori Bawah
xnb	Kanakanabu
xnh	Kuanhua
xni	Ngarigu
xnj	Chingoni
xnk	Nganakarti
xnm	Ngumbarl
xnn	Northern Kankanay
xnq	Xingoni
xnr	Kangri
xns	Kanashi
xnt	Narragansett
xnu	Nunukul
xny	Nyiyaparli
xnz	Mattokki
xoc	O’chi’chi’
xod	Kokoda
xog	Soga
xoi	Kominimung
xok	Xokleng
xom	Komo
xon	Konkomba
xoo	Xukurú
xop	Kopar
xor	Korubo
xow	Kowaki
xpa	Pirriya
xpb	Northeastern Tasmanian
xpd	Oyster Bay Tasmanian
xpe	Liberia Kpelle
xpf	Southeast Tasmanian
xph	North Midlands Tasmanian
xpj	Mpalitjanh
xpk	Kulina Pano
xpl	Port Sorell Tasmanian
xpm	Pumpokol
xpn	Kapinawá
xpo	Pochutec
xpq	Mohegan-Pequot
xpt	Punthamara
xpv	Northern Tasmanian
xpw	Northwestern Tasmanian
xpx	Southwestern Tasmanian
xpz	Bruny Island Tasmanian
xra	Krahô
xrb	Eastern Karaboro
xrd	Gundungurra
xre	Kreye
xrg	Minang
xri	Krikati-Timbira
xrn	Arin
xrt	Aranama-Tamique
xru	Marriammu
xrw	Karawa
xsb	Sambal
xse	Sempan
xsh	Shamang
xsi	Sio
xsj	Subi
xsl	South Slavey
xsm	Kasem
xsn	Sanga
xso	Solano
xsp	Silopi
xsq	Makhuwa-Saka
xsr	Sherpa
xsu	Sanumá
xsv	Sudovian
xsy	Saisiyat
xta	Alcozauca Mixtec
xtb	Chazumba Mixtec
xtc	Katcha-Kadugli-Miri
xtd	Diuxi-Tilantongo Mixtec
xte	Ketengban
xth	Yitha Yitha
xti	Sinicahua Mixtec
xtj	San Juan Teita Mixtec
xtl	Tijaltepec Mixtec
xtm	Magdalena Peñasco Mixtec
xtn	Northern Tlaxiaco Mixtec
xtp	San Miguel Piedras Mixtec
xts	Sindihui Mixtec
xtt	Tacahua Mixtec
xtu	Cuyamecalco Mixtec
xtv	Thawa
xtw	Tawandê
xty	Yoloxóchitl Mixtec
xua	Alu Kurumba
xub	Betta Kurumba
xud	Umiida
xug	Kunigami
xuj	Jennu Kurumba
xul	Ngunawal
xun	Unggaranggu
xuo	Kuo
xup	Upper Umpqua
xut	Kuthant
xuu	Khwedam
xvi	Komviri
xwa	Kwaza
xwc	Woccon
xwd	Wadi Wadi
xwe	Xwela Gbe
xwg	Kwegu
xwj	Wajuk
xwk	Wangkumara
xwl	Western Xwla Gbe
xwr	Kwerba Mamberamo
xwt	Wotjobaluk
xww	Wemba Wemba
xxb	Boro
xxk	Ke’o
xxm	Minkin
xxr	Koropó
xxt	Tambora
xya	Yaygir
xyb	Yandjibara
xyj	Mayi-Yapi
xyk	Mayi-Kulan
xyl	Yalakalore
xyt	Mayi-Thakurti
xyy	Yorta Yorta
xzm	Zemgalian
yaa	Yaminahua
yab	Yuhup
yac	Pass Valley Yali
yad	Yagua
yae	Pumé
yaf	Yaka
yag	Yámana
yah	Yazghulami
yai	Yagnobi
yaj	Banda-Yangere
yak	Yakama
yal	Jalunga
yam	Yamba
yan	Mayangna
yao	Yao
yap	Yapese
yaq	Yaqui
yar	Yabarana
yas	Nugunu
yat	Yambeta
yau	Hodï
yav	Yangben
yaw	Yawalapití
yax	Yauma
yay	Agwagwune
yaz	Lokaa
yba	Yala
ybb	Yemba
ybe	West Yugur
ybh	Yakkha
ybi	Yamphu
ybj	Hasha
ybk	Bokha
ybl	Yukuben
ybm	Yaben
ybn	Yabaâna
ybo	Yabong
ybx	Yawiyo
yby	Yaweyuha
ych	Chesu
ycl	Lolopo
ycn	Yucuna
ycp	Chepya
ycr	Yilan Creole
yda	Yanda
ydd	Eastern Yiddish
yde	Yangum Dey
ydg	Yadgha
ydk	Yoidik
yea	Ravula
yec	Yeniche
yee	Yimas
yei	Yeni
yej	Yevanic
yer	Tarok
yet	Yetfa
yeu	Yerukula
yev	Yeri
yey	Yeyi
yga	Malyangapa
ygi	Yiningayi
ygl	Yangum Gel
ygm	Tandɨ
ygp	Gepo
ygr	Yagaria
ygs	Yolngu Sign Language
ygu	Yugul
ygw	Yagwoia
yha	Baha Buyang
yhd	Judeo-Iraqi Arabic
yhl	Hlepho Phowa
yhs	Yan-nhangu Sign Language
yia	Yinggarda
yif	Ache
yig	Wusa Nasu
yih	Western Yiddish
yii	Yidiny
yij	Yindjibarndi
yik	Dongshanba Lalo
yil	Yindjilandji
yim	Yimchungru Naga
yin	Riang Lai
yip	Pholo
yiq	Miqie
yir	North Awyu
yis	Yis
yit	Eastern Lalu
yiu	Awu
yiv	Northern Nisu
yix	Axi
yiz	Azhe
yka	Yakan
ykg	Northern Yukaghir
ykh	Khamnigan Mongol
yki	Yoke
ykk	Yakaikeke
ykl	Khlula
ykm	Kap
ykn	Kua-nsi
yko	Iyasa
ykr	Yekora
ykt	Kathu
yku	Kuamasi
yky	Yakoma
yla	Ulwa
ylb	Yaleba
yle	Yélî Dnye
ylg	Yalaku
yli	Angguruk Yali
yll	Yil
ylm	Limi
yln	Langnian Buyang
ylo	Naluo
ylr	Yalarnnga
ylu	Aribwaung
yly	Nyelâyu
ymb	Yambes
ymc	Southern Muji
ymd	Muda
yme	Yameo
ymg	Yamongeri
ymh	Mili
ymi	Moji
ymk	Maraba
yml	Iamalele
ymm	Maay
ymn	Sunum
ymo	Yangum Mon
ymp	Yamap
ymq	Qila Muji
ymr	Malasar
ymx	Northern Muji
ymz	Muzi
yna	Aluo
ynd	Yandruwandha
yne	Lang’e
yng	Yango
ynk	Naukan Yupik
ynl	Dubuporo
ynn	Yana
yno	Yong
ynq	Yendang
yns	Iyansi
ynu	Yahuna
yob	Yoba
yog	Yogad
yoi	Yonaguni
yok	Yokuts
yol	Yola
yom	Yombe
yon	Yongkom
yor	Yoruba
yot	Yotti
yox	Yoron
yoy	Yoy
ypa	Phala
ypb	Labo Phowa
ypg	Phola
yph	Phupha
ypm	Phuma
ypn	Ani Phowa
ypo	Alo Phola
ypp	Phupa
ypz	Phuza
yra	Yerakai
yrb	Yareba
yre	Yaouré
yrk	Nenets
yrl	Nengatu
yrm	Yirrk-Mel
yrn	Yerong
yro	Yaroamë
yrs	Yarsun
yrw	Yarawata
yry	Yarluyandi
ysc	Yassic
ysd	Samatao
ysg	Sonaga
ysl	Slovenian Sign Language
ysm	Myanmar Sign Language
ysn	Sani
yso	Nisi
ysp	Southern Lolopo
ysr	Sirenik Yupik
yss	Yessan-Mayo
ysy	Sanie
yta	Talu
ytl	Tanglang
ytp	Thopho
ytw	Yout Wam
yty	Yatay
yua	Yucatec Maya
yub	Yugambal
yuc	Yuchi
yud	Judeo-Tripolitanian Arabic
yue	Yue Chinese
yuf	Havasupai-Walapai-Yavapai
yug	Yug
yui	Wajiara
yuj	Karkar-Yuri
yuk	Yuki
yul	Yulu
yum	Quechan
yun	Bena
yup	Yukpa
yuq	Yuqui
yur	Yurok
yut	Yopno
yuw	Yau
yux	Southern Yukaghir
yuy	East Yugur
yuz	Yuracare
yva	Yawa
yvt	Yavitero
ywa	Kalou
ywg	Yinhawangka
ywl	Western Lalu
ywn	Yawanawa
ywq	Wuding-Luquan Yi
ywr	Yawuru
ywt	Central Lalo
ywu	Wumeng Nasu
yww	Yawarawarga
yxa	Mayawali
yxg	Yagara
yxl	Yardliyawarra
yxm	Yinwum
yxu	Yuyu
yxy	Yabula Yabula
yyr	Yir-Yoront
yyu	Yau
yyz	Ayizi
yzg	E’ma Buyang
yzk	Zokhuo
zaa	Sierra de Juárez Zapotec
zab	Western Tlacolula Valley Zapotec
zac	Ocotlán Zapotec
zad	Cajonos Zapotec
zae	Yareni Zapotec
zaf	Ayoquesco Zapotec
zag	Zaghawa
zah	Zamwal
zai	Isthmus Zapotec
zaj	Zaramo
zak	Zanaki
zal	Zauzou
zam	Miahuatlán Zapotec
zao	Ozolotepec Zapotec
zaq	Aloápam Zapotec
zar	Rincón Zapotec
zas	Santo Domingo Albarradas Zapotec
zat	Tabaa Zapotec
zau	Zangskari
zav	Yatzachi Zapotec
zaw	Mitla Zapotec
zax	Xadani Zapotec
zay	Zayse
zaz	Zari
zbc	Central Berawan
zbe	East Berawan
zbt	Batui
zbu	Bu
zbw	West Berawan
zca	Coatecas Altas Zapotec
zcd	Las Delicias Zapotec
zch	Central Hongshuihe Zhuang
zdj	Ngazidja Comorian
zea	Zeeuws
zeg	Zenag
zeh	Eastern Hongshuihe Zhuang
zem	Zeem
zen	Zenaga
zga	Kinga
zgb	Guibei Zhuang
zgh	Standard Moroccan Tamazight
zgm	Minz Zhuang
zgn	Guibian Zhuang
zgr	Magori
zhb	Zhaba
zhd	Dai Zhuang
zhi	Zhire
zhn	Nong Zhuang
zhw	Zhoa
zia	Zia
zib	Zimbabwe Sign Language
zik	Zimakani
zil	Zialo
zim	Mesme
zin	Zinza
ziw	Zigula
ziz	Zizilivakan
zka	Kaimbulawa
zkd	Kadu
zkk	Karankawa
zkn	Kanan
zko	Kott
zkp	São Paulo Kaingáng
zkr	Zakhring
zku	Kaurna
zkv	Krevinian
zla	Zula
zlj	Liujiang Zhuang
zlm	Malay
zln	Lianshan Zhuang
zlq	Liuqian Zhuang
zlu	Zul
zma	Manda
zmb	Zimba
zmc	Margany
zmd	Maridan
zme	Mangerr
zmf	Mfinu
zmg	Marti Ke
zmh	Makolkol
zmi	Negeri Sembilan Malay
zmj	Maridjabin
zmk	Mandandanyi
zml	Matngala
zmm	Marimanindji
zmn	Mbangwe
zmo	Molo
zmp	Mbuun
zmq	Mituku
zmr	Maranunggu
zms	Mbesa
zmt	Maringarr
zmu	Muruwari
zmv	Mbariman-Gudhinma
zmw	Mbo
zmx	Bomitaba
zmy	Mariyedi
zmz	Mbandja
zna	Zan Gula
zne	Zande
zng	Mang
znk	Manangkari
zns	Mansi
zoc	Copainalá Zoque
zoh	Chimalapa Zoque
zom	Zo
zoo	Asunción Mixtepec Zapotec
zoq	Tabasco Zoque
zor	Rayón Zoque
zos	Francisco León Zoque
zpa	Lachiguiri Zapotec
zpb	Yautepec Zapotec
zpc	Choapan Zapotec
zpd	Southeastern Ixtlán Zapotec
zpe	Petapa Zapotec
zpf	San Pedro Quiatoni Zapotec
zpg	Guevea de Humboldt Zapotec
zph	Totomachapan Zapotec
zpi	Santa María Quiegolani Zapotec
zpj	Quiavicuzas Zapotec
zpk	Tlacolulita Zapotec
zpl	Lachixío Zapotec
zpm	Mixtepec Zapotec
zpn	Santa Inés Yatzechi Zapotec
zpo	Amatlán Zapotec
zpp	El Alto Zapotec
zpq	Zoogocho Zapotec
zpr	Santiago Xanica Zapotec
zps	Coatlán Zapotec
zpt	San Vicente Coatlán Zapotec
zpu	Yalálag Zapotec
zpv	Chichicapan Zapotec
zpw	Zaniza Zapotec
zpx	San Baltazar Loxicha Zapotec
zpy	Mazaltepec Zapotec
zpz	Texmelucan Zapotec
zqe	Qiubei Zhuang
zrg	Mirgan
zrn	Zerenkel
zro	Záparo
zrs	Mairasi
zsa	Sarasira
zsl	Zambian Sign Language
zsm	Standard Malay
zsr	Southern Rincon Zapotec
zsu	Sukurum
zte	Elotepec Zapotec
ztg	Xanaguía Zapotec
ztl	Lapaguía-Guivini Zapotec
ztm	San Agustín Mixtepec Zapotec
ztn	Santa Catarina Albarradas Zapotec
ztp	Loxicha Zapotec
ztq	Quioquitani-Quierí Zapotec
zts	Tilquiapan Zapotec
ztt	Tejalapan Zapotec
ztu	Güilá Zapotec
ztx	Zaachila Zapotec
zty	Yatee Zapotec
zuh	Tokano
zul	Zulu
zum	Kumzari
zun	Zuni
zuy	Zumaya
zwa	Zay
zyb	Yongbei Zhuang
zyg	Yang Zhuang
zyj	Youjiang Zhuang
zyn	Yongnan Zhuang
zyp	Zyphe Chin
zzj	Zuojiang Zhuang