aaa	NG
aab	NG
aac	PG
aad	PG
aae	IT
aaf	IN
aag	PG
aah	PG
aai	PG
aak	PG
aal	CM, NG
aan	BR
aao	DZ
aap	BR
aaq	US
aar	DJ, ER, ET
aas	TZ
aat	GR
aau	PG
aaw	PG
aax	ID
aaz	ID
aba	CI
abb	CM
abc	PH
abd	PH
abe	CA
abf	MY
abg	PG
abh	AF, TJ
abi	CI
abj	IN
abk	GE
abl	ID
abm	NG
abn	NG
abo	NG
abp	PH
abq	RU
abr	CI, GH
abs	ID
abt	PG
abu	CI
abv	BH, SA
abw	PG
abx	PH
aby	PG
abz	ID
aca	CO
acb	NG
acd	GH
ace	ID
acf	DM, GD, LC, MQ
ach	SS, UG
aci	IN
ack	IN
acl	IN
acm	IQ, IR, SY
acn	CN, MM
acp	NG
acq	YE
acr	GT
acs	BR
act	NL
acu	EC, PE
acv	US
acw	SA
acx	OM
acy	CY
acz	SD
ada	GH
adb	TL
add	CM, NG
ade	GH, TG
adf	OM
adg	AU
adh	UG
adi	CN, IN
adj	CI
adl	IN
adn	ID
ado	PG
adq	GH, TG
adr	ID
ads	GH
adt	AU
adu	NG
adw	BR
adx	CN
ady	RU
adz	PG
aea	AU
aeb	TN
aec	EG
aed	AR
aee	AF
aek	NC
ael	CM
aem	LA, VN
aen	AM
aeq	PK
aer	AU
aes	US
aeu	CN
aew	PG
aey	PG
aez	PG
afb	IQ, KW, QA, SA
afd	PG
afe	NG
afg	AF
afi	PG
afk	PG
afn	NG
afo	NG
afp	PG
afr	BW, ZA
afs	MX
aft	SD
afu	GH
afz	ID
aga	PE
agb	NG
agc	NG
agd	PG
age	PG
agf	ID
agg	PG
agh	CD
agi	IN
agj	ET
agk	PH
agl	PG
agm	PG
agn	PH
ago	PG
agq	CM
agr	PE
ags	CM
agt	PH
agu	GT
agv	PH
agw	SB
agx	RU
agy	PH
agz	PH
aha	GH
ahb	VU
ahg	ET
ahh	ID
ahi	CI
ahk	CN, LA, MM, TH
ahl	TG
ahm	CI
ahn	NG
aho	IN
ahp	CI
ahr	IN
ahs	NG
aht	US
aia	SB
aib	CN
aic	PG
aid	AU
aie	PG
aif	PG
aig	AG, AI, KN, MF, MS
aih	CN
aii	IQ
aij	IL
aik	NG
ail	PG
aim	IN
ain	JP
aio	IN
aip	ID
aiq	AF
air	ID
ait	BR
aiw	ET
aix	PG
aiy	CF
aja	SS
ajg	BJ, TG
aji	NC
ajn	AU
ajs	DZ
aju	MA
ajw	NG
ajz	IN
aka	GH
akb	ID
akc	ID
akd	NG
ake	BR, GY, VE
akf	NG
akg	ID
akh	PG
aki	PG
akj	IN
akl	PH
akm	IN
ako	SR
akp	GH
akq	PG
akr	VU
aks	TG
akt	PG
aku	CM, NG
akv	RU
akw	CG
akx	IN
aky	IN
akz	US
ala	NG
alc	CL
ald	CI
ale	US
alf	NG
alh	AU
ali	PG
alj	PH
alk	LA
all	IN
alm	VU
aln	AL, ME, MK, RS
alo	ID
alp	ID
alq	CA
alr	RU
als	AL, GR
alt	RU
alu	SB
alw	ET
alx	PG
aly	AU
alz	CD, UG
ama	BR
amb	NG
amc	BR, PE
ame	PE
amf	ET
amg	AU
amh	ET
ami	TW
amj	TD
amk	ID
aml	BD, IN
amm	PG
amn	PG
amo	NG
amp	PG
amq	ID
amr	PE
ams	JP
amt	PG
amu	MX
amv	ID
amw	SY
amx	AU
amy	AU
amz	AU
ana	CO
anb	PE
anc	NG
and	ID
ane	NC
anf	GH
anh	PG
ani	RU
anj	PG
ank	NG
anl	MM
anm	IN
ann	NG
ano	CO
anp	IN
anq	IN
anr	IN
ans	CO
ant	AU
anu	ET, SS
anv	CM
anw	NG
anx	PG
any	CI, GH
anz	PG
aoa	ST
aob	PG
aoc	BR, GY, VE
aod	PG
aoe	PG
aof	PG
aog	PG
aoi	AU
aoj	PG
aok	NC
aol	ID
aom	PG
aon	PG
aor	VU
aos	ID
aot	BD, IN
aou	CN
aox	BR, GY
aoz	ID
apb	SB
apc	IL, JO, LB, PS, SY, TR
apd	SD, SS
ape	PG
apf	PH
apg	ID
aph	NP
api	BR
apj	US
apk	US
apl	US
apm	US
apn	BR
apo	PG
app	VU
apq	IN
apr	PG
aps	PG
apt	IN
apu	BR
apv	BR
apw	US
apx	ID
apy	BR
apz	PG
aqc	RU
aqd	ML
aqg	NG
aqk	NG
aqm	ID
aqn	PH
aqp	US
aqr	NC
aqt	PY
aqz	BR
arb	SA
ard	AU
are	AU
arg	ES
arh	CO
ari	US
arj	BR
ark	BR
arl	PE
arn	AR, CL
aro	BO
arp	US
arq	DZ
arr	BR
ars	IQ, JO, SA, SY
aru	BR
arv	ET
arw	GF, SR
arx	BR
ary	EH, MA
arz	EG
asa	TZ
asb	CA
asc	ID
ase	US
asf	AU
asg	NG
ash	PE
asi	ID
asj	CM
ask	AF
asl	ID
asm	IN
asn	BR
aso	PG
asp	DZ
asq	AT
asr	IN
ass	CM
ast	ES, PT
asu	BR
asv	CD
asw	AU
asx	PG
asy	ID
asz	ID
ata	PG
atb	CN, MM
atc	PE
atd	PH
ate	PG
atg	NG
ati	CI
atj	CA
atk	PH
atl	PH
atm	PH
atn	IR
ato	CM
atp	PH
atq	ID
atr	BR
ats	US
att	PH
atu	SS
atv	RU
atw	US
atx	BR, VE
aty	VU
atz	PH
aua	SB
aub	CN
auc	EC
aud	SB
aug	BJ, TG
auh	CD, ZM
aui	PG
auj	LY
auk	PG
aul	VU
aum	NG
aun	PG
auo	NG
aup	PG
auq	ID
aur	PG
aut	PF
auu	ID
auw	ID
aux	BR
auy	PG
auz	IR, UZ
ava	AZ, GE, RU
avb	PG
avd	IR
ave	IR
avi	CI
avl	EG, JO, PS
avm	AU
avn	GH
avo	BR
avs	PE
avt	PG
avu	CD, SS
avv	BR
awa	IN, NP
awb	PG
awc	NG
awe	BR
awg	AU
awh	ID
awi	PG
awk	AU
awm	PG
awn	ET
awo	NG
awr	ID
aws	ID
awt	BR
awu	ID
awv	ID
aww	PG
awx	PG
awy	ID
axb	AR
axe	AU
axg	BR
axk	CF, CG
axl	AU
axx	NC
aya	PG
ayb	BJ
ayc	PE
ayd	AU
aye	NG
ayg	TG
ayh	YE
ayi	NG
ayk	NG
ayl	EG, LY, NE
ayn	YE
ayo	BO, PY
ayp	IQ, SY, TR
ayq	PG
ayr	BO, CL, PE
ays	PH
ayt	PH
ayu	NG
ayz	ID
aza	CN
azb	IQ, IR, TR
azd	MX
azg	MX
azj	AM, AZ, GE
azm	MX
azn	MX
azo	CM
azt	PH
azz	MX
baa	SB
bab	GW
bac	ID
bae	VE
baf	CM
bag	CM
bah	BS
baj	ID
bak	RU
bam	CI, ML
ban	ID
bao	BR, CO
bap	IN, NP
bar	AT
bas	CM
bau	NG
bav	CM
baw	CM
bax	CM
bay	ID
bba	BJ, NG
bbb	PG
bbc	ID
bbd	PG
bbe	CD
bbf	PG
bbg	GA
bbh	CN
bbi	CM
bbj	CM
bbk	CM
bbl	GE
bbm	CD
bbn	PG
bbo	BF, ML
bbp	CF
bbq	CM
bbr	PG
bbs	NG
bbt	NG
bbu	NG
bbv	PG
bbw	CM
bbx	CM
bby	CM
bca	CN
bcb	SN
bcc	IR, PK
bcd	ID
bce	CM
bcf	PG
bcg	GN
bch	PG
bci	CI
bcj	AU
bck	AU
bcl	PH
bcm	PG
bcn	NG
bco	PG
bcp	CD
bcq	ET
bcr	CA
bcs	NG
bct	CD
bcu	PG
bcv	NG
bcw	CM
bcy	NG
bcz	SN
bda	GW, SN
bdb	ID
bdc	CO
bdd	PG
bde	NG
bdf	PG
bdg	MY
bdh	CD, SS
bdi	SD
bdj	SS
bdk	AZ
bdl	ID
bdm	CM, NG, TD
bdn	CM
bdo	TD
bdp	TZ
bdq	VN
bdr	MY
bds	TZ
bdt	CF
bdu	CM
bdv	IN
bdw	ID
bdx	ID
bdy	AU
bdz	PK
bea	CA
beb	CM
bec	CM, NG
bed	ID
bee	IN, NP
bef	PG
beg	BN
beh	BF, BJ, TG
bei	ID
bej	EG, ER, SD
bek	PG
bel	BY
bem	CD, ZM
ben	BD, IN
beo	PG
bep	ID
beq	CG
bes	TD
bet	CI
beu	ID
bev	CI
bew	ID
bex	SS
bey	PG
bez	TZ
bfa	SS
bfb	IN
bfc	CN
bfd	CM
bfe	ID
bff	CF
bfg	ID
bfh	PG
bfi	GB
bfj	CM
bfk	TH
bfl	CF
bfm	CM
bfn	ID, TL
bfo	BF
bfp	CM
bfq	IN
bfr	IN
bfs	CN
bft	IN, PK
bfu	IN
bfw	IN
bfx	PH
bfy	IN
bfz	IN
bga	NG
bgb	ID
bgc	IN
bgd	IN
bge	IN
bgf	CM
bgg	IN
bgi	PH
bgj	CM
bgk	CN, LA
bgl	LA
bgn	AF, IR, PK
bgo	GN
bgp	PK
bgq	IN
bgr	BD, IN, MM
bgs	PH
bgt	SB
bgu	CM, NG
bgv	ID
bgw	IN
bgx	TR
bgy	ID
bgz	ID
bha	IN
bhb	IN
bhc	ID
bhd	IN
bhe	PK
bhf	PG
bhg	PG
bhh	IL
bhi	IN
bhj	NP
bhl	PG
bhm	OM
bhn	GE
bho	IN, NP
bhp	ID
bhq	ID
bhr	MG
bhs	CM
bht	IN
bhu	IN
bhv	ID
bhw	ID
bhx	IN
bhy	CD
bhz	ID
bia	AU
bib	BF, GH, TG
bid	TD
bie	PG
bif	GW
big	PG
bil	NG
bim	GH
bin	NG
bio	PG
bip	CD
biq	PG
bir	PG
bis	VU
bit	PG
biu	IN
biv	CI, GH
biw	CM
bix	IN
biy	IN
biz	CD
bja	CD
bjb	AU
bjc	PG
bje	CN
bjf	IL
bjg	GW
bjh	PG
bji	ET
bjj	IN
bjk	PG
bjl	PG
bjm	IQ
bjn	ID
bjo	CD, CF
bjp	PG
bjr	PG
bjs	BB
bjt	SN
bju	CM
bjv	TD
bjw	CI
bjx	PH
bjy	AU
bjz	PG
bka	NG
bkc	CM, GA
bkd	PH
bkf	CD
bkg	CD, CF
bkh	CM
bki	VU
bkj	CF
bkk	IN, PK
bkl	ID
bkm	CM
bkn	ID, MY
bko	CM
bkp	CD
bkq	BR
bkr	ID
bks	PH
bkt	CD
bku	PH
bkv	NG
bkw	CG, CM, GA
bkx	TL
bky	CM, NG
bkz	ID
bla	CA, US
blb	SB
blc	CA
bld	ID
ble	GW
blf	ID
blh	LR
bli	CD
blj	ID
blk	MM, TH
bll	US
blm	SS
bln	PH
blo	BJ, TG
blp	SB
blq	PG
blr	CN, MM, TH
bls	ID
blt	CN, LA, VN
blv	AO
blw	PH
blx	PH
bly	BJ
blz	ID
bma	NG
bmb	CD, TZ
bmc	PG
bmd	GN
bme	CF
bmf	SL
bmg	CD
bmh	PG
bmi	TD
bmj	NP
bmk	PG
bml	CD
bmm	MG
bmn	PG
bmo	CM
bmp	PG
bmq	BF, ML
bmr	CO
bms	NE
bmt	CN
bmu	PG
bmv	CM
bmw	CG, CM
bmx	PG
bmz	PG
bna	ID
bnb	MY
bnd	ID
bne	ID
bnf	ID
bng	GA, GQ
bni	CD, CG
bnj	PH
bnk	VU
bnl	SO
bnm	CM, GQ
bnn	TW
bno	PH
bnp	PG
bnq	ID
bnr	VU
bns	IN
bnu	ID
bnv	ID
bnw	PG
bnx	CD
bny	MY
bnz	CM
boa	CO, PE
bob	KE
bod	CN, IN
boe	CM
bof	BF, ML
bog	ML
boh	CD
boi	US
boj	PG
bok	CG
bol	NG
bom	NG
bon	PG
boo	ML
bop	PG
boq	PG
bor	BR
bos	BA, ME
bot	SS
bou	TZ
bov	GH
bow	PG
box	BF
boy	CF
boz	ML
bpa	VU
bpc	CM
bpd	CF
bpe	PG
bpg	ID
bph	RU
bpi	PG
bpj	CD
bpk	NC
bpl	AU
bpm	PG
bpn	CN
bpo	ID
bpp	ID
bpq	ID
bpr	PH
bps	PH
bpt	AU
bpu	PG
bpv	ID
bpw	PG
bpx	IN
bpy	BD, IN
bpz	ID
bqa	BJ
bqb	ID
bqc	BJ, NG
bqd	CM
bqf	GN
bqg	TG
bqh	CN
bqi	IR
bqj	SN
bqk	CF
bql	PG
bqm	CM
bqn	BG
bqo	CM
bqp	NG
bqq	ID
bqr	ID
bqs	PG
bqt	CM
bqu	CD
bqv	NG
bqw	NG
bqx	NG
bqy	ID
bqz	CM
bra	IN
brb	KH, LA, VN
brc	GY
brd	NP
bre	FR
brf	CD
brg	BO
brh	AF, PK
bri	CM
brj	VU
brk	SD
brl	BW, ZW
brm	CD
brn	CR
bro	BT
brp	ID
brq	PG
brr	SB
brs	ID
brt	CM, NG
bru	LA, VN
brv	LA, TH
brw	IN
brx	IN
bry	PG
brz	PG
bsa	ID
bsb	BN, MY
bsc	GN, SN
bse	CM
bsf	NG
bsg	IR
bsh	AF, PK
bsi	CM
bsj	NG
bsk	IN, PK
bsl	NG
bsm	ID
bsn	CO
bso	TD
bsp	GN
bsq	LR
bsr	NG
bss	CM
bst	ET
bsu	ID
bsv	GN
bsw	ET
bsx	NG
bsy	MY
bta	CM, NG
btc	CM
btd	ID
bte	NG
btf	TD
btg	CI
bth	ID, MY
bti	ID
btj	ID
btm	ID
btn	PH
bto	PH
btp	PG
btq	MY
btr	VU
bts	ID
btt	NG
btu	NG
btv	PK
btw	PH
btx	ID
bty	ID
btz	ID
bub	TD
buc	YT
bud	GH, TG
bue	CA
buf	CD
bug	ID
buh	CN
bui	CG
buj	NG
buk	PG
bul	BG, GR, RS, TR
bum	CM
bun	SL
buo	PG
bup	ID
buq	PG
bus	NG
but	PG
buu	CD
buv	PG
buw	GA
bux	NG
buy	SL
buz	NG
bva	TD
bvb	GQ
bvc	SB
bvd	SB
bve	ID
bvf	TD
bvg	CM
bvh	NG
bvi	SS
bvj	NG
bvk	ID
bvl	BO
bvm	CM
bvn	PG
bvo	TD
bvp	CN
bvq	CF
bvr	AU
bvt	ID
bvu	ID
bvv	VE
bvw	NG
bvx	CG
bvy	PH
bvz	ID
bwa	NC
bwb	FJ
bwc	CD, ZM
bwd	PG
bwe	MM
bwf	PG
bwg	MZ, ZW
bwh	CM
bwi	VE
bwj	BF
bwk	PG
bwl	CD
bwm	PG
bwn	CN
bwo	ET
bwp	ID
bwq	BF
bwr	NG
bws	CD
bwt	CM
bwu	GH
bww	CD
bwx	CN
bwy	BF
bwz	CG, GA
bxa	SB
bxb	SS
bxc	GQ
bxd	CN
bxe	ET
bxf	PG
bxg	CD
bxh	PG
bxi	AU
bxj	AU
bxk	KE, UG
bxl	BF
bxm	MN
bxn	AU
bxo	NG
bxp	CM
bxq	NG
bxr	RU
bxs	CM
bxu	CN
bxv	TD
bxw	ML
bxz	PG
bya	PH
byb	CM
byc	NG
byd	ID
bye	PG
byf	NG
byg	SD
byh	NP
byi	CD
byj	NG
byk	CN
byl	ID
bym	AU
byn	ER
byo	CN
byp	NG
byq	TW
byr	PG
bys	NG
byt	SD
byv	CM
byw	NP
byx	PG
byz	PG
bza	LR
bzb	ID
bzc	MG
bzd	CR
bze	ML
bzf	PG
bzg	TW
bzh	PG
bzi	TH
bzj	BZ
bzk	NI
bzl	ID
bzm	CD
bzn	ID
bzo	CD
bzp	ID
bzq	ID
bzr	AU
bzs	BR
bzu	ID
bzv	CM
bzw	NG
bzx	ML
bzy	NG
bzz	CM, NG
caa	GT, HN
cab	BZ, GT, HN
cac	GT, MX
cad	US
cae	SN
caf	CA
cag	PY
cah	PE
caj	AR, BO
cak	GT
cal	MP
cam	NC
can	PG
cao	BO
cap	BO
caq	IN
car	GY, VE
cas	BO
cat	AD, ES, FR
cav	BO
caw	BO
cax	BO, BR
cay	CA, US
caz	BO
cbb	CO
cbc	BR, CO
cbd	CO
cbg	CO
cbi	EC
cbj	BJ
cbk	PH
cbl	MM
cbn	TH
cbo	NG
cbq	NG
cbr	PE
cbs	BR, PE
cbt	PE
cbu	PE
cbv	CO
cbw	PH
cby	CO
ccc	PE
ccd	BR
cce	MZ
ccg	NG
cch	NG
ccj	GW
ccl	TZ
ccm	MY
cco	MX
ccp	BD, IN, MM
ccr	SV
cda	CN
cde	IN
cdf	IN
cdh	IN
cdi	IN
cdj	IN
cdm	NP
cdn	IN
cdo	CN
cdr	NG
cds	TD
cdy	CN
cdz	BD, IN
cea	US
ceb	PH
ceg	PY
cek	MM
cen	NG
ces	CZ
cet	NG
cey	MM
cfa	NG
cfd	NG
cfg	NG
cfm	MM
cga	PG
cgc	PH
cgg	UG
cgk	BT
cha	GU, MP
chb	CO
chc	US
chd	MX
che	RU
chf	MX
chg	TM
chh	US
chj	MX
chk	FM
chl	US
chn	CA, US
cho	US
chp	CA
chq	MX
chr	US
cht	PE
chu	RU
chv	RU
chw	MZ
chx	NP
chy	US
chz	MX
cia	ID
cib	BJ
cic	US
cid	US
cie	NG
cih	IN
cik	IN
cim	IT
cin	BR
cip	MX
cir	NC
ciw	US
ciy	VE
cja	KH, VN
cje	VN
cjh	US
cji	RU
cjk	AO, CD
cjm	VN
cjn	PG
cjo	PE
cjp	CR
cjs	RU
cjv	PG
cjy	CN
ckb	IQ, IR
ckh	BD, MM
ckl	NG
ckm	AT, HR, HU, SK
ckn	MM
cko	BJ, GH, TG
ckq	TD
ckr	PG
cks	NC
ckt	RU
cku	US
ckv	TW
ckx	CM
cky	NG
ckz	GT
cla	NG
clc	CA
cld	IQ
cle	MX
clh	PK
cli	GH
clj	MM
clk	CN, IN
cll	GH
clm	CA, US
clo	MX
clt	MM
clu	PH
clw	RU
cly	MX
cma	VN
cme	BF, CI
cmi	CO
cml	ID
cmm	US
cmn	CN
cmo	KH, VN
cmr	MM
cmt	ZA
cna	IN
cnb	MM
cnc	VN
cng	CN
cnh	IN, MM
cni	PE
cnk	BD, IN, MM
cnl	MX
cno	LA
cnp	CN
cnq	CM
cnr	ME
cns	ID
cnt	MX
cnu	DZ
cnw	MM
coa	CC
cob	GT, MX
coc	MX, US
cod	PE
coe	CO
cof	EC
cog	TH
coh	KE
coj	MX
cok	MX
col	US
com	US
con	CO, EC
coo	CA
cop	EG
coq	US
cor	GB
cos	FR, IT
cot	PE
cou	GN, SN
cov	CN
cow	US
cox	PE
coz	MX
cpa	MX
cpb	BR, PE
cpc	PE
cpg	GR
cpi	NR
cpn	GH
cpo	BF
cps	PH
cpu	PE
cpx	CN
cpy	PE
cqd	CN
cra	ET
crb	DM, GD, GP, LC, VC
crc	VU
crd	US
crf	CO
crg	US
crh	UA
cri	ST
crj	CA
crk	CA
crl	CA
crm	CA
crn	MX
cro	US
crq	AR, PY
crr	US
crs	IO, SC
crt	AR
crv	IN
crw	VN
crx	CA
cry	NG
crz	US
csa	MX
csb	PL
csc	ES
csd	TH
cse	CZ
csf	CU
csg	CL
csh	MM
csi	US
csj	MM
csk	SN
csl	CN
csm	US
csn	CO
cso	MX
csp	CN
csq	HR
csr	CR
css	US
cst	US
csv	MM
csw	CA
csx	KH
csy	MM
csz	US
cta	MX
ctc	US
ctd	IN, MM
cte	MX
ctg	BD
cth	MM
ctl	MX
ctm	US
ctn	NP
cto	CO, PA
ctp	MX
cts	PH
ctt	IN
ctu	MX
cty	IN
ctz	MX
cua	VN
cub	BR, CO
cuc	MX
cuh	KE
cui	CO, VE
cuj	PE
cuk	PA
cul	BR, PE
cuo	VE
cup	US
cuq	CN
cur	NP
cut	MX
cuu	CN
cuv	CM
cuw	NP
cux	MX
cuy	MX
cvg	IN
cvn	MX
cwa	TZ
cwb	MZ
cwd	CA
cwe	TZ
cwg	MY
cwt	SN
cxh	NG
cya	MX
cyb	BO
cym	GB
cyo	PH
czh	CN
czk	CZ, PL
czn	MX
czo	CN
czt	MM
daa	TD
dac	PG
dad	PG
dae	CM
dag	GH
dah	PG
dai	TD
daj	SD
dak	US
dal	KE
dam	NG
dan	DE, DK
dao	MM
daq	IN
dar	RU
das	CI
dau	SD, TD
dav	KE
daw	PH
dax	AU
daz	ID
dba	ML
dbb	NG
dbd	NG
dbe	ID
dbf	ID
dbg	ML
dbi	NG
dbj	MY
dbl	AU
dbm	NG
dbn	ID
dbo	NG
dbp	NG
dbq	CM, NG
dbr	SO
dbt	ML
dbu	ML
dbv	NG
dbw	ML
dby	PG
dcc	IN
dcr	VI
dda	AU
ddd	SS
dde	CG
ddg	TL
ddi	PG
ddj	AU
ddn	BJ, NE, NG
ddo	GE, RU
ddr	AU
dds	ML
ddw	ID
dec	SD
ded	PG
dee	LR
def	IR
deg	NG
deh	PK
dei	ID
dek	CM
dem	ID
dep	US
deq	CF
der	IN
des	BR, CO
deu	AT, BE, CZ, DE, DK
dev	PG
dez	CD
dga	GH
dgb	ML
dgc	PH
dgd	BF
dge	PG
dgg	PG
dgh	NG
dgi	BF
dgk	CF
dgl	SD
dgn	AU
dgo	IN
dgr	CA
dgs	BF
dgt	AU
dgw	AU
dgx	PG
dgz	PG
dhd	IN
dhg	AU
dhi	NP
dhl	AU
dhm	AO, NA
dhn	IN
dho	IN
dhr	AU
dhs	TZ
dhu	AU
dhv	NC
dhw	NP
dhx	AU
dia	PG
dib	SS
dic	CI
did	SS
dif	AU
dig	KE, TZ
dih	MX, US
dii	CM
dij	ID
dik	SS
dil	SD
dim	ET
dio	NG
dip	SS
diq	TR
dir	NG
dis	IN
diu	AO, BW, NA
div	IN, MV
diw	SS
dix	VU
diy	ID
diz	CD
dja	AU
djb	AU
djc	TD
djd	AU
dje	BF, ML, NE, NG
djf	AU
dji	AU
djj	AU
djk	GF, SR
djm	BF, ML
djn	AU
djo	ID
djr	AU
dju	PG
djw	AU
dka	BT
dkg	NG
dkk	ID
dkr	MY
dks	SS
dkx	CM
dlg	RU
dlk	ER
dlm	HR, ME
dln	IN
dma	GA
dmb	ML
dmc	PG
dmd	AU
dme	CM
dmg	MY
dmk	PK
dml	PK
dmm	CM
dmo	CM
dmr	ID
dms	ID
dmu	ID
dmv	MY
dmw	AU
dmx	MZ
dmy	ID
dna	ID
dnd	PG
dne	TZ
dng	KG, KZ
dni	ID
dnj	CI, GN, LR
dnk	ID
dnn	BF
dno	CD, UG
dnr	PG
dnt	ID
dnu	MM
dnv	MM
dnw	ID
dny	BR
doa	PG
dob	PG
doc	CN
doe	TZ
dof	PG
doh	NG
dok	ID
dol	PG
don	PG
doo	CD
dop	BJ, TG
doq	DO
dor	SB
dos	BF
dot	NG
dov	ZW
dow	CM
dox	ET
doy	GH
doz	ET
dpp	MY
drb	SD
drc	PT
drd	IN
dre	NP
drg	MY
dri	NG
drl	AU
drn	ID
dro	MY
drq	NP
drs	ET
drt	NL
dru	TW
dry	NP
dsb	DE
dse	NL
dsh	ET, KE
dsi	TD
dsk	NG
dsl	DK
dsn	ID
dso	IN
dsq	ML
dsz	TR
dta	CN
dtb	MY
dtd	CA
dth	AU
dti	ML
dtk	ML
dtm	BF, ML
dtn	ET
dto	ML
dtp	MY
dtr	MY
dts	ML
dtt	ML
dtu	ML
dty	NP
dua	CM
dub	IN
duc	PG
due	PH
duf	NC
dug	KE
duh	IN
dui	PG
duk	PG
dul	PH
dun	ID
duo	PH
dup	ID, MY
duq	ID
dur	CM
dus	NP
duu	CN, MM
duv	ID
duw	ID
dux	ML
duy	PH
duz	CM
dva	PG
dwa	NG
dwk	IN
dwr	ET
dwu	AU
dww	PG
dwy	AU
dwz	NP
dya	BF
dyb	AU
dyd	AU
dyg	PH
dyi	CI
dym	ML
dyn	AU
dyo	GM, SN
dyr	NG
dyu	BF, CI
dyy	AU
dza	NG
dzd	NG
dze	AU
dzg	NE, TD
dzl	BT
dzn	CD
dzo	BT, IN
eaa	AU
ebc	ID
ebg	NG
ebk	PH
ebo	CD, CG
ebr	CI
ebu	KE
ecs	EC
eee	CN
efa	CM, NG
efe	CD
efi	NG
ega	CI
egl	IT
egm	TZ
ego	NG
ehs	JP
ehu	NG
eip	ID
eit	PG
eiv	PG
eja	GW, SN
eka	NG
eke	NG
ekg	ID
eki	NG
ekk	EE
ekl	BD
ekm	CM
eko	MZ
ekp	NG
ekr	NG
eky	MM, TH
ele	PG
elh	SD
eli	SD
elk	PG
ell	AL, GR
elm	NG
elo	KE
elu	PG
ema	NG
emb	ID
eme	GF
emg	NP
emi	PG
emk	GN, ML, SL
emm	MX
emn	CM
emp	CO, PA
emq	CN
ems	US
emu	IN
emw	ID
emx	FR
emz	CM
ena	PG
enb	KE
enc	VN
end	ID
enf	RU
eng	GB, IE
enh	RU
enl	PY
enn	NG
eno	ID
enq	PG
enr	ID
enu	CN
env	NG
enw	NG
enx	PY
eot	CI
epi	NG
era	IN
erg	VU
erh	NG
eri	PG
erk	VU
ero	CN
err	AU
ers	CN
ert	ID
erw	ID
ese	BO, PE
esg	IN
esh	IR
esi	US
esk	US
esl	EG
esm	CI
esn	SV
eso	EE
esq	US
ess	RU, US
esu	US
esy	PH
etb	NG
etc	US
eth	ET
etn	VU
eto	CM
etr	PG
ets	NG
etu	CM, NG
etx	NG
etz	ID
eud	MX
eus	ES, FR
eve	RU
evh	NG
evn	CN
ewe	GH, TG
ewo	CM
ext	ES
eya	US
eyo	KE
eza	NG
eze	NG
faa	PG
fab	GQ
fad	PG
faf	SB
fag	PG
fah	NG
fai	PG
faj	PG
fak	CM
fal	CM
fam	NG
fan	CM, GA, GQ
fao	FO
fap	SN
far	SB
fau	ID
fax	ES
fay	IR
fbl	PH
fcs	CA
fer	SS
ffi	PG
ffm	ML
fgr	TD
fia	SD
fie	NG
fif	SA
fij	FJ
fil	PH
fin	FI, RU
fip	TZ
fir	NG
fit	FI, SE
fiw	PG
fkk	NG
fkv	NO
fla	US
flh	ID
fli	NG
fll	CM
fln	AU
flr	CD
fly	ZA
fmp	CM
fmu	IN
fnb	VU
fng	ZA
fni	TD
fod	BJ
foi	PG
fom	CD
fon	BJ, TG
for	PG
fos	TW
fpe	GQ
fqs	PG
fra	AD, BE, CH, FR, LU, MC
frc	US
frd	ID
frp	CH, FR, IT
frq	PG
frr	DE
frs	DE
frt	VU
fry	NL
fse	FI
fsl	FR
fss	AX, FI
fub	CM, NG, TD
fuc	GM, GN, GW, ML, MR, SN
fud	WF
fue	BJ
fuf	GN, GW, ML
fuh	BF, BJ, NE
fui	TD
fuj	SD
fum	NG
fun	BR
fuq	NE
fur	IT
fut	VU
fuu	CD, CF
fuv	NG
fuy	PG
fvr	SD, TD
fwa	NC
fwe	NA, ZM
gaa	GH
gab	TD
gac	IN
gad	PH
gae	BR, VE
gaf	PG
gag	MD
gah	PG
gai	PG
gaj	PG
gak	ID
gal	ID, TL
gam	PG
gan	CN
gao	PG
gap	PG
gaq	IN
gar	PG
gas	IN
gat	PG
gau	IN
gaw	PG
gax	ET, KE, SO
gay	ID
gaz	ET
gbb	AU
gbd	AU
gbe	PG
gbf	PG
gbg	CD, CF
gbh	BJ
gbi	ID
gbj	IN
gbk	IN
gbl	IN
gbm	IN
gbn	SS
gbo	LR
gbp	CF
gbq	CF
gbr	NG
gbs	BJ
gbu	AU
gbv	CF
gbw	AU
gbx	BJ
gby	NG
gbz	IR
gcc	PG
gcd	AU
gce	US
gcf	GP
gcl	GD
gcn	PG
gcr	GF
gct	VE
gda	IN
gdb	IN
gdc	AU
gdd	PG
gde	CM, NG
gdf	NG
gdg	PH
gdh	AU
gdi	CF
gdj	AU
gdk	TD
gdl	ET
gdm	TD
gdn	PG
gdo	RU
gdq	OM, YE
gdr	PG
gds	NP
gdt	AU
gdu	NG
gdx	IN
gea	NG
geb	PG
gec	LR
ged	NG
gef	ID
geg	NG
geh	CA, US
gei	ID
gej	BJ, TG
gek	NG
gel	NG
geq	CF
ges	ID
gev	GA
gew	NG
gex	KE, SO
gey	CD
gez	ET
gfk	PG
gft	ET
gga	SB
ggb	LR
ggd	AU
gge	AU
ggg	PK
ggk	AU
ggl	PG
ggt	PG
ggu	CI
ggw	PG
gha	LY
ghe	NP
ghh	NP
ghk	MM
ghl	SD
ghn	SB
gho	MA
ghr	PK
ghs	PG
ght	NP
gia	AU
gib	NG
gic	ZA
gid	CM, TD
gie	CI
gig	PK
gih	AU
gii	ET
gil	KI
gim	PG
gin	RU
gip	PG
giq	VN
gir	CN, VN
gis	CM
git	CA
giu	CN
giw	CN
gix	CD
giy	AU
giz	CM
gjk	PK
gjm	AU
gjn	GH
gjr	AU
gju	IN, PK
gka	PG
gkd	PG
gke	CM
gkn	NG
gko	AU
gkp	GN
gku	ZA
gla	GB
glb	NG
glc	TD
gld	RU
gle	GB, IE
glg	ES, PT
glh	AF
glj	TD
glk	IR
gll	AU
glo	NG
glr	LR
glu	TD
glv	IM
glw	CM, NG
gly	SD
gma	AU
gmb	SB
gmd	NG
gmg	PG
gmm	CM
gmn	CM
gmr	AU
gmu	PG
gmv	ET
gmx	TZ
gmz	NG
gna	BF
gnb	IN
gnc	ES
gnd	CM
gne	NG
gng	BJ, TG
gnh	NG
gni	AU
gnj	CI
gnk	BW
gnl	AU
gnm	PG
gnn	AU
gno	IN
gnq	MY
gnr	AU
gnt	PG
gnu	PG
gnw	BO
gnz	CF
goa	CI
gob	CO, VE
goc	PG
god	CI
goe	BT
gof	ET
gog	TZ
goi	PG
goj	IN
gok	IN
gol	LR, SL
gom	IN
goo	FJ
gop	ID
goq	ID
gor	ID
gos	NL
gou	CM
gov	CI
gow	TZ
gox	CD, CF
goy	TD
goz	IR
gpa	NG
gpe	GH
gpn	PG
gqa	NG
gqi	CN
gqn	BR
gqr	TD
gqu	CN
gra	IN
grc	GR
grd	NG
grg	PG
grh	NG
gri	SB
grj	LR
grm	MY
gro	CN, IN
grq	PG
grr	DZ, MA
grs	ID
grt	BD, IN
gru	ET
grv	LR
grw	PG
grx	PG
gry	LR
grz	PG
gse	GH
gsg	DE
gsl	SN
gsm	GT
gsn	PG
gso	CF
gsp	PG
gss	GR
gsw	AT, CH, DE, FR, LI
gta	BR
gtu	AU
gua	NG
gub	BR
guc	CO, VE
gud	CI
gue	AU
guf	AU
gug	PY
guh	CO, VE
gui	BO
guj	IN
guk	ET, SD
gul	US
gum	CO
gun	AR, BR, PY
guo	CO
gup	AU
guq	PY
gur	BF, GH
gus	GN
gut	CR
guu	BR, VE
guw	BJ, NG
gux	BF, BJ, NE, TG
guz	KE, TZ
gva	PY
gvc	BR, CO
gve	PG
gvf	PG
gvj	BR
gvl	TD
gvm	NG
gvn	AU
gvo	BR
gvp	BR
gvr	NP
gvs	PG
gvy	AU
gwa	CI
gwb	NG
gwc	PK
gwd	ET
gwe	TZ
gwf	PK
gwg	NG
gwi	CA
gwj	BW
gwm	AU
gwn	NG
gwr	UG
gwt	AF, PK
gwu	AU
gww	AU
gwx	GH
gxx	CI
gya	CF, CM
gyb	PG
gyd	AU
gye	NG
gyf	AU
gyg	CF
gyi	CM, GQ
gyl	ET
gym	CR, PA
gyn	GY
gyo	NP
gyr	BO
gyy	AU
gyz	NG
gza	SD
gzi	IR
gzn	ID
haa	US
hab	VN
hac	IQ, IR
had	ID
hae	ET
haf	VN
hag	GH
hah	PG
haj	BD, IN
hak	CN, HK
hal	LA, VN
ham	PG
han	TZ
hao	PG
hap	ID
haq	TZ
har	ET
has	CA
hat	HT
hau	NE, NG
hav	CD
haw	US
hax	CA
hay	TZ
haz	AF
hba	CD
hbb	NG
hbn	SD
hbo	IL
hbu	TL
hca	IN
hch	MX
hdn	CA, US
hds	HN
hdy	ET
hea	CN
heb	IL
hed	TD
heg	ID
heh	TZ
hei	CA
hem	CD
her	AO, BW, NA
hgm	NA
hgw	PG
hhi	PG
hhr	SN
hhy	PG
hia	NG
hib	PE
hid	US
hif	FJ
hig	NG
hih	PG
hii	IN
hij	CM
hik	ID
hil	PH
hin	IN
hio	BW
hir	BR
hiw	VU
hix	BR
hji	ID
hka	TZ
hke	CD
hkh	IN
hkk	PG
hkn	KH
hks	HK
hla	PG
hlb	IN
hld	LA, VN
hle	CN
hlt	IN, MM
hma	CN
hmb	BF, ML
hmc	CN
hmd	CN
hme	CN
hmf	VN
hmg	CN
hmh	CN
hmi	CN
hmj	CN
hml	CN
hmm	CN
hmo	PG
hmp	CN
hmq	CN
hmr	IN
hms	CN
hmt	PG
hmu	ID
hmv	VN
hmw	CN
hmy	CN
hmz	CN
hna	CM
hnd	PK
hne	IN
hng	AO
hnh	BW
hni	CN, LA, VN
hnj	CN, LA, TH, VN
hnn	PH
hno	PK
hns	SR
hnu	LA, VN
hoa	SB
hob	PG
hoc	IN
hod	NG
hoe	NG
hoh	OM, YE
hoi	US
hoj	IN
hol	AO, CD
hom	SS
hoo	CD
hop	US
hor	TD
hos	VN
hot	PG
hov	ID
how	CN
hoy	IN
hoz	ET
hpo	MM
hps	US
hra	IN
hrc	PG
hre	VN
hrk	ID
hrm	CN
hro	VN
hrp	AU
hrt	TR
hru	IN
hrv	AT, HR, ME
hrw	PG
hrx	BR
hrz	IR
hsb	DE
hsh	HU
hsl	NG
hsn	CN
hss	OM
hti	ID
hto	CO
hts	TZ
htu	ID
hub	PE
huc	BW
hud	ID
hue	MX
huf	PG
hug	PE
huh	CL
hui	PG
huj	CN
huk	ID
hul	PG
hum	CD
hun	AT, HU, RO, RS, SK, UA
huo	CN
hup	US
huq	CN
hur	CA
hus	MX
hut	NP
huu	CO, PE
huv	MX
huw	ID
hux	CO, PE
huy	IL, IR
huz	GE, RU
hvc	HT
hve	MX
hvk	NC
hvn	ID
hvv	MX
hwa	CI
hwc	US
hwo	NG
hya	CM, NG
hye	AM, AZ, IR
hyw	AM, GE, TR
iai	NC
ian	PG
iar	PG
iba	BN, ID, MY
ibb	NG
ibd	AU
ibe	NG
ibg	PH
ibh	VN
ibl	PH
ibm	NG
ibn	NG
ibo	NG
ibr	NG
ibu	ID
iby	NG
ica	BJ
ich	NG
icl	IS
icr	CO
ida	KE
idb	IN
idc	NG
idd	BJ
ide	NG
idi	PG
idr	SS
ids	NG
idt	TL
idu	NG
ifa	PH
ifb	PH
ife	BJ, TG
iff	VU
ifk	PH
ifm	CG
ifu	PH
ify	PH
igb	NG
ige	NG
igg	PG
igl	NG
igm	PG
ign	BO
igo	PG
igw	NG
ihb	ID
ihi	NG
ihp	ID
ihw	AU
iii	CN
iin	AU
ijc	NG
ije	NG
ijj	BJ
ijn	NG
ijs	NG
ike	CA
ikh	NG
iki	NG
ikk	NG
ikl	NG
iko	NG
ikp	NG
ikr	AU
iks	CA
ikt	CA
ikv	NG
ikw	NG
ikx	UG
ikz	TZ
ila	ID
ilb	ZM
ilg	AU
ili	CN
ilk	PH
ilm	MY
ilo	PH
ilp	PH
ils	IT
ilu	ID
ilv	NG
ima	IN
imi	PG
iml	US
imn	PG
imo	PG
imr	ID
imt	SS
inb	CO
ind	ID
ing	US
inh	RU
inj	CO
inl	ID
inn	PH
ino	PG
inp	PE
ins	IN
int	MM
inz	US
ior	ET
iou	PG
iow	US
ipi	PG
ipo	PG
iqu	PE
iqw	NG
ire	ID
irh	ID
iri	NG
irk	TZ
irn	BR
irr	LA
iru	IN
irx	ID
iry	PH
isa	PG
isc	PE
isd	PH
ise	IT
isg	IE
ish	NG
isi	NG
isk	AF, TJ
isl	IS
ism	ID
isn	TZ
iso	NG
isr	IL
ist	HR
isu	CM
ita	CH, HR, IT, SI, SM
itb	PH
itd	ID, MY
ite	BO
iti	PH
itk	IT
itl	RU
itm	NG
ito	BO
itr	PG
its	NG
itt	PH
itv	PH
itw	NG
itx	ID
ity	PH
itz	GT
ium	CN, LA, VN
ivb	PH
ivv	PH
iwk	PH
iwm	PG
iwo	ID
iws	PG
ixc	MX
ixl	GT
iya	NG
iyo	CM
iyx	CG
izh	RU
izm	NG
izr	NG
izz	NG
jaa	BR
jab	NG
jac	GT, MX
jad	GN
jae	PG
jaf	NG
jah	MY
jaj	SB
jak	MY
jal	ID
jam	JM
jan	AU
jao	AU
jaq	ID
jas	NC
jat	AF
jau	ID
jav	ID
jax	ID
jay	AU
jaz	NC
jbe	IL
jbi	AU
jbj	ID
jbk	PG
jbm	NG
jbn	LY
jbr	ID
jbt	BR
jbu	CM, NG
jbw	AU
jcs	JM
jct	RU, UA
jda	IN
jdg	PK
jdt	RU
jeb	PE
jee	NP
jeh	LA, VN
jei	ID
jek	CI
jel	ID
jen	NG
jer	NG
jet	ID, PG
jeu	TD
jgb	CD
jge	IL
jgk	NG
jgo	CM
jhi	MY
jhs	NP
jia	CM
jib	NG
jic	HN
jid	NG
jie	NG
jig	AU
jih	CN
jii	SO
jil	PG
jim	CM
jio	CN
jiq	CN
jit	TZ
jiu	CN
jiv	EC
jiy	CN
jje	KR
jjr	NG
jka	ID
jkm	MM
jko	PG
jkp	MM
jkr	IN
jks	JP
jku	NG
jle	SD
jls	JM
jma	PG
jmb	NG
jmc	TZ
jmd	ID
jmi	NG
jml	NP
jmn	IN, MM
jmr	GH
jms	NG
jmw	PG
jmx	MX
jna	IN
jnd	PK
jng	AU
jni	NG
jnj	ET
jnl	IN
jns	IN
job	CD
jod	CI
jog	PK
jor	BO
jos	JO
jow	ML
jpn	JP
jpr	IL
jqr	PE
jra	KH, VN
jrr	NG
jrt	NG
jru	VE
jsl	JP
jua	BR
jub	NG
juc	CN
jud	CI
juh	NG
jui	AU
juk	NG
jul	NP
jum	SD, SS
jun	IN
juo	NG
jup	BR, CO
jur	BR
jus	NP
juu	NG
juw	NG
juy	IN
jvd	ID
jvn	SR
jwi	GH
jya	CN
jye	YE
jyy	TD
kaa	UZ
kab	DZ
kac	CN, MM
kad	NG
kae	TW
kaf	CN
kag	MY
kah	CF
kai	NG
kaj	NG
kak	PH
kal	GL
kam	KE, TZ
kan	IN
kao	ML
kap	GE, RU
kaq	PE
kas	IN, PK
kat	GE, TR
kav	BR
kax	ID
kay	BR
kaz	CN, KZ, MN, UZ
kba	AU
kbb	BR
kbc	BR
kbd	RU
kbe	AU
kbg	IN
kbh	CO
kbi	ID
kbj	CD
kbk	PG
kbl	TD
kbm	PG
kbn	CF, CM
kbo	CD, SS
kbp	BJ, TG
kbq	PG
kbr	ET
kbs	GA
kbt	PG
kbu	PK
kbv	ID, PG
kbw	PG
kbx	PG
kby	NE, NG
kbz	NG
kca	RU
kcb	PG
kcc	NG
kcd	ID
kce	NG
kcf	NG
kcg	NG
kch	NG
kci	NG
kcj	GW
kck	BW, ZW
kcl	PG
kcm	CF, SD
kcn	UG
kco	PG
kcp	SD
kcq	NG
kcr	SD
kcs	NG
kct	PG
kcu	TZ
kcv	CD
kcw	CD
kcx	ET
kcy	DZ
kcz	TZ
kda	AU
kdc	TZ
kdd	AU
kde	MZ, TZ
kdf	PG
kdg	CD
kdh	TG
kdi	UG
kdj	UG
kdk	NC
kdl	NG
kdm	NG
kdn	MZ, ZM, ZW
kdp	NG
kdq	BD, IN
kdr	LT, RU
kdt	KH, LA, TH
kdu	SD
kdw	ID
kdx	NG
kdy	ID
kdz	CM
kea	CV
keb	GA
kec	SD
ked	TZ
kee	US
kef	TG
keg	SD
keh	PG
kei	ID
kej	IN
kek	BZ, GT
kel	CD
kem	ID, TL
ken	CM
keo	CD, SS, UG
kep	IN
keq	IN
ker	CM, TD
kes	NG
ket	RU
keu	TG
kev	IN
kew	PG
kex	IN
key	IN
kez	NG
kfa	IN
kfb	IN
kfc	IN
kfd	IN
kfe	IN
kff	IN
kfg	IN
kfh	IN
kfi	IN
kfj	CN
kfk	IN
kfl	CM
kfm	IR
kfn	CM
kfo	CI
kfp	IN
kfq	IN
kfr	IN
kfs	IN
kft	IN
kfu	IN
kfv	IN
kfw	IN
kfx	IN
kfy	IN
kfz	BF, ML
kga	CI
kgb	ID
kge	ID
kgf	PG
kgg	NP
kgi	MY
kgj	NP
kgk	BR
kgl	AU
kgn	IR
kgo	SD
kgp	BR
kgq	ID
kgr	ID
kgs	AU
kgt	NG
kgu	PG
kgv	ID
kgw	ID
kgx	ID
kgy	CN, NP
kha	BD, IN
khb	CN, LA, MM
khc	ID
khd	ID
khe	ID
khf	LA
khg	CN, MM
khh	ID
khj	NG
khk	MN, RU
khl	PG
khm	KH, VN
khn	IN
khp	ID
khq	ML
khr	IN
khs	PG
kht	MM
khu	AO
khv	RU
khw	PK
khx	CD
khy	CD
khz	PG
kia	TD
kib	SD
kic	MX, US
kid	CM
kie	TD
kif	NP
kig	ID
kih	PG
kii	US
kij	PG
kik	KE
kil	NG
kim	RU
kin	CD, RW, UG
kio	US
kip	NP
kiq	ID
kir	CN, KG, TJ
kis	PG
kit	PG
kiu	TR
kiv	TZ
kiw	PG
kix	IN, MM
kiy	ID
kiz	TZ
kja	ID
kjb	GT
kjc	ID
kjd	PG
kje	ID
kjg	CN, LA, TH, VN
kjh	RU
kji	SB
kjj	AZ
kjk	ID
kjl	NP
kjm	VN
kjn	AU
kjo	IN
kjp	MM, TH
kjq	US
kjr	ID
kjs	PG
kjt	TH
kju	US
kjx	PG
kjy	PG
kjz	BT
kka	NG
kkb	ID
kkc	PG
kkd	NG
kke	GN
kkf	IN
kkg	PH
kkh	MM
kki	TZ
kkj	CF, CM
kkk	SB
kkl	ID
kkm	NG
kkn	CN
kko	SD
kkp	AU
kkq	CD
kkr	NG
kks	NG
kkt	NP
kku	NG
kkv	ID
kkw	CG
kkx	ID
kky	AU
kkz	CA
kla	US
klb	MX
klc	CM
kld	AU
kle	IN, NP
klf	TD
klg	PH
klh	PG
kli	ID
klj	IR
klk	NG
kll	PH
klm	PG
klo	NG
klp	PG
klq	PG
klr	NP
kls	PK
klt	PG
klu	LR
klv	VU
klw	ID
klx	PG
kly	ID
klz	ID
kma	GH
kmb	AO
kmc	CN
kmd	PH
kme	CM
kmf	PG
kmg	PG
kmh	PG
kmi	NG
kmj	IN
kmk	PH
kml	PH
kmm	IN
kmn	PG
kmo	PG
kmp	CM
kmq	ET
kmr	AM, AZ, IQ, IR, SY, TR
kms	PG
kmt	ID
kmu	PG
kmv	BR
kmw	CD
kmx	PG
kmy	CM, NG
kmz	IR
kna	NG
knb	PH
knc	CM, NE, NG, TD
knd	ID
kne	PH
knf	GW, SN
kng	CD, CG
kni	NG
knj	GT, MX
knk	GN, SL
knl	ID
knm	BR
knn	IN
kno	SL
knp	CM
knq	MY
knr	PG
kns	MY, TH
knt	BR
knu	GN
knv	PG
knw	BW, NA
knx	ID, MY
kny	CD
knz	BF, ML
koa	PG
koc	NG
kod	ID
koe	ET, SS
kof	NG
kog	CO
koh	CG
koi	RU
kol	PG
koo	CD, UG
kop	PG
koq	CG, GA
kor	KP, KR
kos	FM
kot	CM, TD
kou	TD
kov	NG
kow	NG
koy	US
koz	PG
kpa	NG
kpb	IN
kpc	BR, CO, VE
kpd	ID
kpf	PG
kpg	FM
kph	GH
kpi	ID
kpj	BR
kpk	NG
kpl	CD
kpm	VN
kpn	BR
kpo	GH, TG
kpq	ID
kpr	PG
kps	ID
kpt	RU
kpu	ID
kpv	RU
kpw	PG
kpx	PG
kpy	RU
kpz	UG
kqa	PG
kqb	PG
kqc	PG
kqd	IQ
kqe	PH
kqf	PG
kqg	BF
kqh	TZ
kqi	PG
kqj	PG
kqk	BJ
kql	PG
kqm	BF, CI
kqn	CD, ZM
kqo	LR
kqp	TD
kqq	BR
kqr	MY
kqs	GN, SL
kqt	MY
kqu	ZA
kqv	ID, MY
kqw	PG
kqx	CM, TD
kqy	ET
kqz	ZA
kra	NP
krb	US
krc	RU
krd	TL
kre	BR
krf	VU
krh	NG
kri	SL
krj	PH
krk	RU
krl	RU
krn	LR
krp	CM, NG
krr	KH
krs	SD, SS
krt	NE
kru	BD, IN, NP
krv	KH
krw	CI, LR
krx	SN
kry	AZ
krz	ID
ksb	TZ
ksc	PH
ksd	PG
kse	PG
ksf	CM
ksg	SB
ksh	DE
ksi	PG
ksj	PG
ksk	US
ksl	PG
ksm	NG
ksn	PH
kso	NG
ksp	CF, NG, TD
ksq	NG
ksr	PG
kss	LR, SL
kst	BF
ksu	IN
ksv	CD
ksw	MM, TH
ksx	ID
ksy	IN
ksz	IN
kta	VN
ktb	ET
ktc	NG
ktd	AU
kte	NP
ktf	CD
ktg	AU
kth	TD
kti	ID
ktj	CI
ktk	PG
ktl	IR
ktm	PG
ktn	BR
kto	PG
ktp	CN, LA
kts	ID
ktt	ID
ktu	CD
ktv	VN
ktw	US
ktx	BR
kty	CD
ktz	BW, NA
kua	AO, NA
kub	CM, NG
kuc	ID
kud	PG
kue	PG
kuf	LA
kug	NG
kuh	NG
kui	BR
kuj	KE, TZ
kuk	ID
kul	NG
kum	RU
kun	ER
kuo	PG
kup	PG
kuq	BR
kus	BF, GH, TG
kut	CA, US
kuu	US
kuv	ID
kuw	CF
kux	AU
kuy	AU
kuz	CL
kva	RU
kvb	ID
kvc	PG
kvd	ID
kve	MY
kvf	TD
kvg	PG
kvh	ID
kvi	TD
kvj	CM, NG
kvk	KP, KR
kvl	MM
kvm	CM
kvn	CO, PA
kvo	ID
kvp	ID
kvq	MM
kvr	ID
kvt	MM
kvu	MM
kvv	ID
kvw	ID
kvx	PK
kvy	MM
kvz	ID
kwa	BR
kwb	NG
kwc	CG
kwd	SB
kwe	ID
kwf	SB
kwg	TD
kwh	ID
kwi	CO, EC
kwj	PG
kwk	CA
kwl	NG
kwm	NA
kwn	AO, NA
kwo	PG
kwp	CI
kwr	ID
kws	CD
kwt	ID
kwu	CM
kwv	TD
kww	SR
kwx	IN
kwy	AO
kwz	AO
kxa	PG
kxb	CI
kxc	ET
kxd	BN
kxf	MM
kxh	ET
kxi	MY
kxj	TD
kxk	MM
kxm	TH
kxn	MY
kxo	BR
kxp	IN, PK
kxq	ID
kxr	PG
kxs	CN
kxt	PG
kxv	IN
kxw	PG
kxx	CG
kxy	VN
kxz	PG
kya	TZ
kyb	PH
kyc	PG
kyd	ID
kye	GH
kyf	CI
kyg	PG
kyh	US
kyi	MY
kyj	PH
kyk	PH
kyl	US
kym	CF
kyn	PH
kyo	ID
kyp	LA
kyq	TD
kyr	BR
kys	MY
kyt	ID
kyu	MM
kyv	NP
kyw	IN
kyx	PG
kyy	PG
kyz	BR
kza	BF
kzb	ID
kzc	CI, GH
kzd	ID
kze	PG
kzf	ID
kzg	JP
kzi	ID, MY
kzk	SB
kzl	ID
kzm	ID
kzn	MW, MZ
kzo	GA
kzp	ID
kzq	NP
kzr	CM, TD
kzs	MY
kzu	ID
kzv	ID
kzw	BR
kzx	ID
kzy	CD
kzz	ID
laa	PH
lac	MX
lad	IL
lae	IN
laf	SD
lag	TZ
lai	MW, TZ, ZM
laj	UG
lal	CD
lam	CD, ZM
lan	NG
lao	KH, LA
lap	CF, TD
laq	CN, VN
lar	GH
las	BJ, TG
lat	VA
lau	ID
law	ID
lax	IN
lay	CN
laz	PG
lbb	PG
lbc	CN
lbe	RU
lbf	CN, IN
lbg	LA
lbi	CM
lbj	IN
lbk	PH
lbl	PH
lbm	IN
lbn	LA
lbo	LA
lbq	PG
lbr	NP
lbs	LY
lbt	CN, VN
lbu	PG
lbv	PG
lbw	ID
lbx	ID
lby	AU
lbz	AU
lcc	ID
lcd	ID
lce	ID
lcf	ID
lch	AO
lcl	ID
lcm	PG
lcp	TH
lcq	ID
lcs	ID
lda	CI, GN
ldb	NG
ldd	NG
ldg	NG
ldh	NG
ldi	CG
ldj	NG
ldk	NG
ldl	NG
ldm	GN
ldo	NG
ldp	NG
ldq	NG
lea	CD
leb	CD, ZM
lec	BO
led	CD
lee	BF
lef	GH
leh	ZM
lei	PG
lej	CD
lek	PG
lel	CD
lem	CM
len	HN
leo	CM
lep	BT, IN, NP
leq	PG
ler	PG
les	CD
let	PG
leu	PG
lev	ID
lew	ID
lex	ID
ley	ID
lez	AZ, RU
lfa	CM
lga	SB
lgb	SB
lgg	CD, UG
lgh	VN
lgi	ID
lgk	VU
lgl	SB
lgm	CD
lgn	ET, SS
lgo	SS
lgq	GH
lgr	SB
lgs	GW
lgt	PG
lgu	SB
lgz	CD
lha	VN
lhh	ID
lhi	CN, MM
lhl	IN
lhm	CN, IN, NP
lhn	MY
lhp	BT
lhs	SY
lht	VU
lhu	CN, LA, MM
lia	SL
lib	PG
lic	CN
lid	PG
lie	CD
lif	IN, NP
lig	GH
lih	PG
lij	FR, IT, MC
lik	CD
lil	CA
lim	BE, NL
lin	CD, CG
lio	ID
lip	GH
liq	ET
lir	LR
lis	CN, MM
lit	LT
liu	SD
liv	LV
liw	ID
lix	ID
liy	CF
liz	CD
lja	AU
lje	ID
lji	ID
ljl	ID
ljp	ID
ljw	AU
ljx	AU
lka	TL
lkb	KE
lkc	VN
lkd	BR
lke	UG
lkh	BT
lki	IR
lkj	MY
lkl	PG
lkm	AU
lkn	VU
lko	KE
lkr	SS
lks	KE
lkt	CA, US
lku	AU
lky	SS
lla	NG
llb	MZ
llc	GN
lld	IT
lle	PG
llf	PG
llg	ID
llh	CN
lli	CG
llj	AU
llk	MY
lll	PG
llm	ID
lln	TD
llp	VU
llq	ID
lls	LT
llu	SB
llx	FJ
lma	GN, SL
lmb	VU
lmc	AU
lmd	SD
lme	CM, TD
lmf	ID
lmg	PG
lmh	NP
lmi	CD
lmj	ID
lmk	IN
lml	VU
lmn	IN
lmo	CH, IT
lmp	CM
lmq	ID
lmr	ID
lmu	VU
lmv	FJ
lmw	US
lmx	CM
lmy	ID
lna	CD, CF
lnb	NA
lnd	BN, ID, MY
lnh	MY
lni	PG
lnj	AU
lnl	CF
lnm	PG
lnn	VU
lns	CM
lnu	NG
lnw	AU
lnz	CD
loa	ID
lob	BF, CI
loc	PH
loe	ID
lof	SD
log	CD
loh	SS
loi	CI
loj	PG
lok	SL
lol	CD
lom	LR
lon	MW
loo	CD
lop	NG
loq	CD
lor	BF, CI
los	PG
lot	SS
lou	US
lov	CN
low	MY
lox	ID
loy	NP
loz	BW, ZM, ZW
lpa	VU
lpe	ID
lpn	MM
lpo	CN
lpx	SS
lqr	SS
lra	ID, MY
lrc	IR
lre	CA
lrg	AU
lri	KE
lrk	PK
lrl	IR
lrm	KE
lrn	ID
lro	SD
lrr	NP
lrt	ID
lrv	VU
lrz	VU
lsa	IR
lsb	BI
lsc	MX
lsd	IL
lse	CD
lsh	IN
lsi	CN, MM
lsl	LV
lsm	KE, UG
lsn	CN
lso	LA
lsp	PA
lsr	PG
lss	PK
lst	TT
lsv	PE
lsw	SC
lsy	MU
ltg	LV
lth	UG
lti	ID
ltn	BR
lto	KE
lts	KE
ltu	ID
ltz	BE, DE, FR, LU
lua	AO, CD
lub	CD
luc	UG
lud	RU
lue	AO, ZM
luf	PG
lug	UG
lui	US
luj	CD
luk	BT
lul	SS
lum	AO
lun	AO, CD, ZM
luo	KE, TZ
lup	CG, GA
luq	CU
lur	ID
lus	BD, IN, MM
lut	US
luu	NP
luv	OM
luw	CM
luz	IR
lva	TL
lvi	LA
lvk	SB
lvl	CD
lvs	LV
lvu	ID
lwa	AO, CD
lwe	ID
lwg	KE
lwh	VN
lwl	TH
lwm	CN
lwo	SS
lws	MW
lwt	ID
lwu	CN
lww	VU
lxm	PG
lya	BT
lyg	BD, IN
lyn	ZM
lzh	CN
lzl	VU
lzn	MM
lzz	GE, TR
maa	MX
mab	MX
mad	ID
mae	NG
maf	CM, NG
mag	IN
mah	MH
mai	IN, NP
maj	MX
mak	ID
mal	IN
mam	GT, MX
maq	MX
mar	IN
mas	KE, TZ
mat	MX
mau	MX
mav	BR
maw	GH
max	ID
maz	MX
mba	PH
mbb	PH
mbc	BR, GY, VE
mbd	PH
mbe	US
mbf	SG
mbh	PG
mbi	PH
mbj	BR
mbk	PG
mbl	BR
mbm	CG
mbn	CO
mbo	CM
mbp	CO
mbq	PG
mbr	CO
mbs	PH
mbt	PH
mbu	NG
mbv	GN
mbw	PG
mbx	PG
mby	PK
mbz	MX
mca	PY
mcb	PE
mcc	PG
mcd	PE
mce	MX
mcf	BR, PE
mcg	VE
mch	BR, VE
mci	PG
mcj	NG
mck	AO, ZM
mcl	CO
mcm	MY
mcn	CM, TD
mco	MX
mcp	CM
mcq	PG
mcr	PG
mcs	CM, TD
mct	CM
mcu	CM
mcv	PG
mcw	TD
mcx	CF, CG, CM
mcy	PG
mcz	PG
mda	NG
mdb	PG
mdc	PG
mdd	CM
mde	TD
mdf	RU
mdg	TD
mdh	PH
mdi	CD
mdj	CD
mdk	CD
mdl	MT
mdm	CD
mdn	CF
mdp	CD
mdq	CD
mdr	ID
mds	PG
mdt	CG, GA
mdu	CG
mdv	MX
mdw	CG
mdx	ET
mdy	ET
mdz	BR
mea	CM
meb	PG
mec	AU
med	PG
mee	PG
mef	BD
meh	MX
mei	SD
mej	ID
mek	PG
mel	MY
mem	AU
men	LR, SL
meo	MY, TH
mep	AU
meq	CM
mer	KE
mes	TD
met	PG
meu	PG
mev	GN, LR
mew	NG
mey	DZ, EH, ML, MR
mez	US
mfa	TH
mfb	ID
mfc	CD
mfd	CM
mfe	MU
mff	CM
mfg	GN
mfh	CM
mfi	CM, NG
mfj	CM
mfk	CM
mfl	NG
mfm	NG
mfn	NG
mfo	NG
mfp	ID
mfq	BF, TG
mfr	AU
mfs	MX
mft	PG
mfu	AO
mfv	GM, GW, SN
mfw	PG
mfx	ET
mfy	MX
mfz	SS
mgb	TD
mgc	SS
mgd	SS
mge	TD
mgf	ID
mgg	CM
mgh	MZ, TZ
mgi	NG
mgj	NG
mgk	ID
mgl	PG
mgm	TL
mgn	CF
mgo	CM
mgp	NP
mgq	TZ
mgr	TZ, ZM
mgs	TZ
mgt	PG
mgu	PG
mgv	TZ
mgw	TZ
mgy	TZ
mgz	TZ
mha	IN
mhb	GA
mhc	MX
mhd	TZ
mhe	MY
mhf	PG
mhg	AU
mhi	SS, UG
mhj	AF
mhk	CM
mhl	PG
mhm	MZ
mhn	IT
mho	AO, ZM
mhp	ID
mhq	US
mhr	RU
mhs	ID
mht	VE
mhu	CN, IN
mhw	AO, BW, NA, ZM
mhx	MM
mhy	ID
mhz	ID
mia	US
mib	MX
mic	CA
mid	IQ, IR
mie	MX
mif	CM
mig	MX
mih	MX
mii	MX
mij	CM
mik	US
mil	MX
mim	MX
min	ID
mio	MX
mip	MX
miq	HN, NI
mir	MX
mit	MX
miu	MX
miw	PG
mix	MX
miy	MX
miz	MX
mjb	TL
mjc	MX
mjd	US
mje	TD
mjg	CN
mjh	TZ
mji	CN
mjj	PG
mjk	PG
mjl	IN
mjm	PG
mjn	PG
mjo	IN
mjp	IN
mjq	IN
mjr	IN
mjs	NG
mjt	BD, IN
mju	IN
mjv	IN
mjw	IN
mjx	IN
mjy	US
mjz	NP
mka	CI
mkb	IN
mkc	PG
mkd	BG, GR, MK
mke	IN
mkf	NG
mkg	CN
mki	PK
mkj	FM
mkk	CM
mkl	BJ
mkm	TH
mkn	ID
mko	NG
mkp	PG
mkq	US
mkr	PG
mks	MX
mkt	NC
mku	GN
mkv	VU
mkw	CG
mkx	PH
mky	ID
mkz	TL
mla	VU
mlb	CM
mlc	VN
mle	PG
mlf	LA, TH
mlh	PG
mli	ID
mlj	TD
mlk	KE
mll	VU
mlm	CN
mln	SB
mlo	SN
mlp	PG
mlq	GM, ML, SN
mlr	CM
mls	SD, TD
mlt	MT
mlu	SB
mlv	VU
mlw	CM
mlx	VU
mlz	PH
mma	NG
mmb	ID
mmc	MX
mmd	CN
mme	VU
mmf	NG
mmg	VU
mmh	BR
mmi	PG
mmj	IN
mmk	IN
mml	CN
mmm	VU
mmn	PH
mmo	PG
mmp	PG
mmq	PG
mmr	CN
mmt	PG
mmu	CM
mmv	BR
mmw	VU
mmx	PG
mmy	TD
mmz	CD
mna	PG
mnb	ID
mnc	CN
mnd	BR
mne	TD
mnf	CM
mng	VN
mnh	CD
mni	BD, IN
mnj	AF
mnk	GM, GW, SN
mnl	VU
mnm	PG
mnn	VN
mnp	CN
mnq	MY
mnr	US
mns	RU
mnu	ID
mnv	SB
mnw	MM, TH
mnx	ID
mny	MZ
mnz	ID
moa	CI
moc	AR
mod	US
moe	CA
mog	ID
moh	CA, US
moi	NG
moj	CD, CF, CG
mok	ID
mom	NI
moo	VN
mop	BZ, GT
moq	ID
mor	SD
mos	BF, ML, TG
mot	CO, VE
mou	TD
mov	US
mow	CG
mox	PG
moy	ET
moz	TD
mpa	TZ
mpb	AU
mpc	AU
mpd	BO, BR
mpe	ET
mpg	TD
mph	AU
mpi	CM, TD
mpj	AU
mpk	TD
mpl	PG
mpm	MX
mpn	PG
mpo	PG
mpp	PG
mpq	BR
mpr	SB
mps	PG
mpt	PG
mpu	BR
mpv	PG
mpw	BR, GY
mpx	PG
mpy	ID
mpz	TH
mqa	ID
mqb	CM
mqc	ID
mqe	PG
mqf	ID
mqg	ID
mqh	MX
mqi	ID
mqj	ID
mqk	PH
mql	BJ, TG
mqm	PF
mqn	ID
mqo	ID
mqp	ID
mqq	MY
mqr	ID
mqs	ID
mqt	MM, TH
mqu	SS
mqv	PG
mqw	PG
mqx	ID
mqy	ID
mqz	PG
mra	LA, TH
mrb	VU
mrc	US
mrd	NP
mre	US
mrf	ID
mrg	IN
mrh	IN, MM
mri	NZ
mrj	RU
mrk	NC
mrl	FM
mrm	VU
mrn	SB
mro	BD, MM
mrp	VU
mrq	PF
mrr	IN
mrs	VU
mrt	NG
mru	CM
mrv	PF
mrw	PH
mrx	ID
mry	PH
mrz	ID
msb	PH
msc	GN
msd	MX
mse	CM, TD
msf	ID
msg	ID
msh	MG
msi	MY
msj	CD
msk	PH
msl	ID
msm	PH
msn	VU
mso	ID
msp	BR
msq	NC
msr	MN
mss	ID
msu	PG
msv	CM, TD
msw	GW
msx	PG
msy	PG
msz	PG
mta	PH
mtb	CI
mtc	PG
mtd	ID
mte	SB
mtf	PG
mtg	ID
mth	ID
mti	PG
mtj	ID
mtk	CM
mtl	NG
mtm	RU
mtn	NI
mto	MX
mtp	BO
mtq	VN
mtr	IN
mts	PE
mtt	VU
mtu	MX
mtv	PG
mtw	PH
mtx	MX
mty	PG
mua	CM, TD
mub	TD
muc	CM
mud	RU
mue	EC
mug	CM, TD
muh	CD, SS
mui	ID
muj	TD
muk	NP
mum	PG
muo	CM
mup	IN
muq	CN
mur	SS
mus	US
mut	IN
muu	KE
muv	IN
mux	PG
muy	CM
muz	ET
mva	PG
mvb	US
mvd	ID
mve	PK
mvf	CN, MN
mvg	MX
mvh	TD
mvi	JP
mvk	PG
mvl	AU
mvn	PG
mvo	SB
mvp	ID
mvq	PG
mvr	ID
mvs	ID
mvt	VU
mvu	TD
mvv	ID, MY
mvw	TZ
mvx	ID
mvy	PK
mvz	ET
mwa	PG
mwb	PG
mwc	PG
mwe	TZ
mwf	AU
mwg	PG
mwh	PG
mwi	VU
mwk	ML
mwl	PT
mwm	TD
mwn	TZ, ZM
mwo	VU
mwp	AU
mwq	MM
mws	KE
mwt	MM, TH
mwu	SS
mwv	ID
mww	CN
mwz	CD
mxa	MX
mxb	MX
mxc	MZ, ZW
mxd	ID
mxe	VU
mxf	CM, TD
mxg	AO
mxh	CD
mxj	CN, IN
mxk	PG
mxl	BJ, TG
mxm	PG
mxn	ID
mxo	ZM
mxp	MX
mxq	MX
mxr	MY
mxs	MX
mxt	MX
mxu	CM
mxv	MX
mxw	PG
mxx	CI
mxy	MX
mxz	ID
mya	MM
myb	CF, TD
myc	CD
mye	GA
myf	ET
myg	CM
myh	US
myj	SS
myk	ML
myl	ID
mym	ET
myo	ET
myp	BR
myr	PE
mys	ET
myu	BR
myv	RU
myw	PG
myx	UG
myy	BR, CO
myz	IR
mza	MX
mzb	DZ
mzc	MG
mzd	CM
mze	PG
mzh	AR
mzi	MX
mzj	GN, LR
mzk	NG
mzl	MX
mzm	NG
mzn	IR
mzo	BR
mzp	BO
mzq	ID
mzr	BR
mzs	MO
mzt	MY
mzu	PG
mzv	CF
mzw	GH
mzx	GY
mzy	MZ
mzz	PG
naa	ID
nab	BR
nac	PG
nae	ID
naf	PG
nag	IN
naj	GN, GW
nak	PG
nal	PG
nam	AU
nan	CN, TW
nao	CN, NP
nap	IT
naq	NA
nar	NG
nas	PG
nat	NG
nau	NR
nav	US
naw	GH
nax	PG
nay	AU
naz	MX
nba	AO
nbb	NG
nbc	IN
nbd	CD
nbe	IN, MM
nbg	IN
nbh	NG
nbi	IN
nbj	AU
nbk	PG
nbl	ZA
nbm	CD, CF
nbn	ID
nbo	NG
nbp	NG
nbq	ID
nbr	NG
nbs	NA
nbt	IN
nbu	IN
nbv	CM
nbw	CD
nby	PG
nca	PG
ncb	IN
ncc	PG
ncd	NP
nce	PG
ncf	PG
ncg	CA
nch	MX
ncj	MX
nck	AU
ncl	MX
ncm	PG
ncn	PG
nco	PG
ncq	LA
ncr	CM
ncs	NI
nct	IN
ncu	GH
ncx	MX
ncz	US
nda	CG, GA
ndb	CM
ndc	MZ, ZW
ndd	NG
nde	BW, ZW
ndg	TZ
ndh	MW, TZ
ndi	CM, NG
ndj	TZ
ndk	CD
ndl	CD
ndm	TD
ndn	CG
ndo	NA
ndp	CD, UG
ndq	AO
ndr	CM, NG
nds	BR, DE
ndt	CD
ndu	CM
ndv	SN
ndw	CD
ndx	ID
ndy	CF, TD
ndz	SS
nea	ID
neb	CI
nec	ID
ned	NG
nee	NC
nef	IN
neg	RU
neh	BT
nej	PG
nek	NC
nem	NC
nen	NC
neo	VN
neq	MX
ner	ID
nes	IN
net	PG
nev	LA
new	IN, NP
nex	PG
ney	CI
nez	US
nfa	ID
nfd	NG
nfl	SB
nfr	GH
nfu	CM
nga	CD, CG
ngb	CD
ngc	CD
ngd	CF
nge	CM
ngg	CF
ngh	ZA
ngi	NG
ngj	CM
ngk	AU
ngl	MZ
ngm	FM
ngn	CM
ngp	TZ
ngq	TZ
ngr	SB
ngs	CM, NG
ngt	LA
ngu	MX
ngv	CM
ngw	NG
ngx	NG
ngy	CM
ngz	CG
nha	AU
nhb	CI
nhc	MX
nhd	BR, PY
nhe	MX
nhf	AU
nhg	MX
nhh	IN
nhi	MX
nhk	MX
nhm	MX
nhn	MX
nho	PG
nhp	MX
nhq	MX
nhr	BW, NA
nht	MX
nhu	CM
nhv	MX
nhw	MX
nhx	MX
nhy	MX
nhz	MX
nia	ID
nib	PG
nid	AU
nie	TD
nif	PG
nig	AU
nih	TZ, ZM
nii	PG
nij	ID
nik	IN
nil	ID
nim	TZ
nin	NG
nio	RU
niq	KE
nir	ID
nis	PG
nit	IN
niu	NU
niv	RU
niw	PG
nix	CD
niy	CD
niz	PG
nja	CM, NG
njb	IN
njd	TZ
njh	IN
nji	AU
njj	CM
njl	SS
njm	IN
njn	IN
njo	IN
njr	NG
njs	ID
njt	SR
nju	AU
njx	CG
njy	CG, CM
njz	IN
nka	ZM
nkb	IN
nkc	CM
nkd	IN
nke	SB
nkf	IN
nkg	PG
nkh	IN
nki	IN
nkj	ID
nkk	VU
nkm	PG
nkn	AO
nko	GH
nkp	TO
nkq	GH
nkr	FM
nks	ID
nkt	TZ
nku	CI
nkv	MW, ZM
nkw	CD
nkx	NG
nkz	NG
nla	CM
nlc	ID
nld	BE, NL
nle	KE
nlg	SB
nli	AF
nlj	CD
nlk	ID
nll	IN
nlm	PK
nlo	CD
nlq	MM
nlu	GH
nlv	MX
nlw	AU
nlx	IN
nly	AU
nlz	SB
nma	IN
nmb	VU
nmc	CF, TD
nmd	GA
nme	IN
nmf	IN
nmg	CM, GQ
nmh	IN
nmi	NG
nmj	CF
nmk	VU
nml	CM
nmm	NP
nmn	BW, NA
nmo	IN
nmp	AU
nmq	BW, ZW
nmr	CM
nms	VU
nmt	FM
nmu	US
nmv	AU
nmw	PG
nmx	PG
nmy	CN
nmz	TG
nna	AU
nnb	CD
nnc	TD
nnd	VU
nne	NA
nnf	PG
nng	IN
nnh	CM
nni	ID
nnj	ET
nnk	PG
nnl	IN
nnm	PG
nnn	TD
nnp	IN
nnq	TZ
nnr	AU
nnt	US
nnu	GH
nnv	AU
nnw	BF
nny	AU
nnz	CM
noa	CO
noc	PG
nod	LA, TH
noe	IN
nof	PG
nog	RU
noh	PG
noi	IN
noj	CO
nok	US
nol	US
nop	PG
noq	CD
nor	NO
nos	CN
not	PE
nou	PG
now	TZ
noy	TD
noz	ET
npa	NP
npb	BT
npg	MM
nph	IN
npi	BT, IN, NP
npl	MX
npn	PG
npo	IN
nps	ID
npu	IN
npx	SB
npy	ID
nqg	BJ
nqk	BJ
nql	AO
nqm	ID
nqn	PG
nqo	GN
nqq	MM
nqt	NG
nqy	MM
nra	CG, GA
nrb	ER
nre	IN
nrf	GG, JE
nrg	VU
nri	IN
nrk	AU
nrl	AU
nrm	MY
nrn	GB
nrr	IN
nrt	US
nru	CN
nrx	AU
nrz	PG
nsa	IN
nsb	BW, ZA
nsd	CN
nse	MZ, ZM, ZW
nsf	CN
nsg	TZ
nsh	CM
nsi	NG
nsk	CA
nsl	NO
nsm	IN
nsn	PG
nso	ZA
nsp	NP
nsq	US
nsr	CA
nss	PG
nst	IN, MM
nsu	MX
nsv	CN
nsw	VU
nsx	AO
nsy	ID
nsz	US
ntd	MY
nte	MZ
ntg	AU
nti	BF
ntj	AU
ntk	TZ
ntm	BJ
nto	CD
ntp	MX
ntr	GH, TG
ntu	SB
ntw	US
ntx	MM
nty	VN
ntz	IR
nua	NC
nuc	BR
nud	PG
nue	CD
nuf	CN, MM
nug	AU
nuh	NG
nui	GQ
nuj	UG
nuk	CA
nul	ID
num	TO
nun	MM
nuo	LA, VN
nup	NG
nuq	PG
nur	PG
nus	ET, SS
nut	VN
nuu	CD
nuv	BF
nuw	FM
nux	PG
nuy	AU
nuz	MX
nvh	VU
nvm	PG
nvo	CM
nwa	US
nwb	CI
nwe	CM
nwg	AU
nwi	VU
nwm	SS
nwo	AU
nwr	PG
nww	TZ
nwy	US
nxa	TL
nxd	CD
nxe	ID
nxg	ID
nxi	TZ
nxk	MM
nxl	ID
nxn	AU
nxo	GA
nxq	CN
nxr	ID, PG
nxx	ID
nya	MW, MZ, ZM
nyb	GH
nyc	CD
nyd	KE
nye	AO
nyf	KE
nyg	CD
nyh	AU
nyi	SD
nyj	CD
nyk	AO
nyl	TH
nym	TZ
nyn	RW, UG
nyo	UG
nyp	UG
nyq	IR
nyr	MW
nys	AU
nyt	AU
nyu	MZ
nyv	AU
nyw	TH
nyx	AU
nyy	MW, TZ
nza	CM, NG
nzb	CG, GA
nzd	CD
nzi	CI, GH
nzk	CD, CF
nzm	IN
nzr	NG
nzs	NZ
nzu	CG
nzy	CM, TD
nzz	ML
oaa	RU
oac	RU
obi	US
obk	PH
obl	CM
obo	PH
obu	NG
oca	CO, PE
oci	ES, FR, IT
ocu	MX
oda	NG
odk	IN, PK
odu	NG
ofo	US
ofu	NG
ogb	NG
ogc	NG
ogg	NG
ogo	NG
ogu	NG
oia	ID
oie	SS
oin	PG
ojb	CA
ojc	CA
ojg	CA
ojs	CA
ojv	SB
ojw	CA
oka	CA, US
okb	NG
okc	CD
okd	NG
oke	NG
okg	AU
okh	IR
oki	KE
okj	IN
okk	PG
okl	GB
okn	JP
okr	NG
oks	NG
oku	CM
okv	PG
okx	NG
ola	NP
old	TZ
ole	BT
olk	AU
olm	NG
olo	RU
olr	VU
olu	AO
oma	US
omb	VU
omc	PE
omg	PE
omi	CD
omk	RU
oml	CD
omo	PG
omt	KE
omu	PE
omw	PG
ona	AR
onb	CN
one	CA
ong	PG
oni	ID
onj	PG
onk	PG
onn	PG
ono	CA
onp	IN
onr	PG
ons	PG
ont	PG
onu	VU
onx	ID
ood	MX, US
oog	LA
oon	IN
oor	ZA
opa	NG
opk	ID
opm	PG
opo	PG
opt	MX
opy	BR
ora	SB
orc	KE
ore	PE
org	NG
orh	CN
orn	MY
oro	PG
orr	NG
ors	MY
ort	IN
oru	PK
orw	BR
orx	NG
ory	IN
orz	ID
osa	US
osi	ID
oso	NG
oss	GE, RU
ost	CM
osu	PG
otd	ID
ote	MX
oti	BR
otl	MX
otm	MX
otn	MX
otq	MX
otr	SD
ots	MX
ott	MX
otu	BR
otw	CA, US
otx	MX
otz	MX
oua	DZ
oub	CI, LR
oue	PG
oum	PG
ovd	SE
owi	PG
oyb	LA
oyd	ET
oym	BR, GF
oyy	PG
ozm	CM
pab	BR
pac	LA, VN
pad	BR
pae	CD
paf	BR
pag	PH
pah	BR
pai	NG
pak	BR
pam	PH
pan	IN
pao	US
pap	AW, BQ, CW
paq	TJ
par	US
pas	ID
pau	PW
pav	BR
paw	US
pax	BR
pay	HN
paz	BR
pbb	CO
pbc	GY
pbe	MX
pbf	MX
pbg	VE
pbh	VE
pbi	CM
pbl	NG
pbm	MX
pbn	NG
pbo	GW
pbp	GN, GW, SN
pbr	TZ
pbs	MX
pbt	AF, IR, PK, TJ
pbu	PK
pbv	BD, IN
pby	PG
pca	MX
pcb	KH
pcc	CN, VN
pcd	BE, FR
pce	MM
pcf	IN
pcg	IN
pch	IN
pci	IN
pcj	IN
pck	IN
pcl	IN
pcm	NG
pcn	NG
pcp	BO
pcw	NG
pda	PG
pdc	US
pdi	CN
pdn	ID
pdo	ID
pdu	MM
pea	ID
peb	US
ped	PG
pee	ID
pef	US
peg	IN
peh	CN
pei	MX
pej	US
pek	PG
pel	ID
pem	CD
pep	PG
peq	US
pes	IR
pev	VE
pex	PG
pey	ID
pez	BN, MY
pfa	FM
pfe	CM
pfl	DE, FR
pga	SS
pgg	IN
pgi	PG
pgk	VU
pgs	NG
pgu	ID
pgz	PG
pha	CN, VN
phd	IN
phg	VN
phh	VN
phj	NP
phk	IN
phl	PK
phm	MZ
pho	LA
phq	LA
phr	PK
pht	LA, TH, VN
phu	LA, TH
phv	AF
phw	NP
pia	MX
pib	PE
pic	GA
pid	CO, VE
pie	US
pif	FM
pig	PE
pih	NF
pij	CO
pil	BJ
pim	US
pin	PG
pio	CO, VE
pip	NG
pir	BR, CO
pis	SB
pit	AU
piu	AU
piv	SB
piw	TZ
pix	PG
piy	NG
piz	NC
pjt	AU
pkb	KE
pkg	PG
pkh	BD, IN
pkn	AU
pko	KE, UG
pkp	CK
pkr	IN
pks	PK
pkt	LA, VN
pku	ID
pla	PG
plb	VU
plc	PH
pld	GB
ple	ID
plg	AR
plh	ID
pli	IN
plk	PK
pll	MM
pln	CO
plo	MX
plr	CI
pls	MX
plt	MG
plu	BR, GF
plv	PH
plw	PH
ply	CN
plz	MY
pma	VU
pmb	CD
pmd	AU
pme	NC
pmf	ID
pmi	CN
pmj	CN
pml	TN
pmm	CM
pmn	CM
pmo	ID
pmq	MX
pmr	PG
pms	IT
pmt	PF
pmw	US
pmx	IN
pmy	ID
pmz	MX
pna	MY
pnb	IN, PK
pnc	ID
pnd	AO
pne	MY
png	NG
pnh	CK
pni	ID
pnj	AU
pnk	BO
pnl	BF
pnm	MY
pnn	PG
pno	PE
pnp	ID
pnq	BF, ML
pnr	PG
pns	ID
pnt	GR, TR
pnu	CN
pnv	AU
pnw	AU
pnx	LA
pny	CM
pnz	CF, CM, TD
poc	GT
poe	MX
pof	CD
pog	BR
poh	GT
poi	MX
pok	BR
pol	CZ, PL, UA
pom	US
pon	FM
poo	US
pop	NC
poq	MX
por	ES, PT
pos	MX
pot	US
pov	GW
pow	MX
pox	DE
poy	TZ
ppe	PG
ppi	MX
ppk	ID
ppl	SV
ppm	ID
ppn	PG
ppo	PG
ppp	CD
ppq	PG
pps	MX
ppt	PG
ppu	TW
pqa	NG
pqm	CA, US
prc	AF
prd	IR
pre	ST
prf	PH
prg	PL
prh	PH
pri	NC
prk	CN, MM
prl	PE
prm	PG
prn	AF
prq	PE
prr	BR
prs	AF
prt	LA, TH
pru	ID
prw	PG
prx	IN
prz	CO
psa	ID
psc	IR
psd	CA, US
pse	ID
psg	MY
psh	AF
psi	AF
psl	PR
psm	BO
psn	ID
pso	PL
psp	PH
psq	PG
psr	PT
pss	PG
pst	PK
psw	VU
psy	US
pta	PY
pth	BR
pti	AU
ptn	ID
pto	BR
ptp	PG
ptq	IN
ptr	VU
ptt	ID
ptu	ID
ptv	VU
ptw	CA
pty	IN
pua	MX
pub	IN
puc	ID
pud	ID
pue	AR
puf	ID
pug	BF
pui	CO, VE
puj	ID
pum	NP
puo	VN
pup	PG
puq	BO, CL, PE
pur	BR
put	ID
puu	CG, GA
puw	FM
pux	PG
puy	US
pwa	PG
pwb	NG
pwg	PG
pwi	US
pwm	MY, PH
pwn	TW
pwo	MM
pwr	IN
pww	TH
pxm	MX
pye	CI
pym	NG
pyn	BR
pys	PY
pyu	TW
pyy	MM
pze	NG
pzh	TW
pzn	MM
qua	US
qub	PE
quc	GT
qud	EC
quf	PE
qug	EC
quh	AR, BO, CL
qui	US
quk	PE
qul	BO
qum	GT
qun	US
qup	PE
quq	ES
qur	PE
qus	AR
quv	GT
quw	EC
qux	PE
quy	PE
quz	PE
qva	PE
qvc	PE
qve	PE
qvh	PE
qvi	EC
qvj	EC
qvl	PE
qvm	PE
qvn	PE
qvo	EC, PE
qvp	PE
qvs	PE
qvw	PE
qvy	CN
qvz	EC, PE
qwa	PE
qwh	PE
qwm	HU
qws	PE
qwt	US
qxa	PE
qxc	PE
qxh	PE
qxl	EC
qxn	PE
qxo	PE
qxp	PE
qxq	IR
qxr	EC
qxs	CN
qxt	PE
qxu	PE
qxw	PE
qyp	US
raa	NP
rab	NP
rac	ID
rad	VN
raf	NP
rag	KE
rah	IN
rai	PG
rak	PG
ral	IN
ram	BR
ran	ID
rao	PG
rap	CL
raq	NP
rar	CK
ras	SD
rat	IR
rau	NP
rav	NP
raw	IN, MM
rax	NG
ray	PF
raz	ID
rbb	CN, MM
rbk	PH
rbl	PH
rbp	AU
rcf	RE
rdb	IR
rea	PG
reb	ID
ree	MY
reg	TZ
rei	IN
rej	ID
rel	KE
rem	PE
ren	VN
rer	ET
res	NG
ret	ID
rey	BO
rga	VU
rge	GR
rgk	IN
rgn	IT, SM
rgr	PE
rgs	VN
rgu	ID
rhg	BD, MM
rhp	PG
ria	BD, IN
rib	CR
rif	MA
ril	MM
rim	TZ
rin	NG
rir	ID
rit	AU
riu	ID
rjg	ID
rji	NP
rjs	NP
rka	KH
rkb	BR
rkh	CK
rki	BD, MM
rkm	BF, ML
rkt	BD, IN
rkw	AU
rma	NI
rmb	AU
rmc	CZ
rmd	DK
rme	GB
rmf	FI
rmg	NO
rmh	ID
rmi	AM
rmk	PG
rmm	ID
rmn	RS
rmo	RS
rmp	PG
rmq	ES
rms	RO
rmt	TR
rmu	SE
rmw	GB
rmx	VN
rmy	RO
rmz	BD, IN
rnb	CR
rnd	CD
rng	MZ, ZA
rnl	IN
rnn	ID
rnp	IN
rnr	AU
rnw	TZ
rob	ID
roc	VN
rod	NG
roe	PG
rof	TZ
rog	VN
roh	CH
rol	PH
ron	MD, RO, UA
roo	PG
rop	AU
ror	ID
rou	CF, TD
row	ID
rpn	VU
rpt	PG
rri	SB
rrm	NZ
rro	PG
rrt	AU
rsb	RS
rsk	HR, RS
rsl	RU
rsm	AU
rsn	RW
rsw	NG
rtc	MM
rth	ID
rtm	FJ
rts	RU
rtw	IN
rub	UG
ruc	UG
rue	SK, UA
ruf	TZ
rug	SB
ruh	IN
rui	TZ
ruk	NG
run	BI
ruo	HR
rup	AL, GR, MK
ruq	GR, MK
rus	BY, GE, KZ, RU, UA
rut	AZ, RU
ruu	MY
ruy	NG
ruz	NG
rwa	PG
rwk	TZ
rwl	TZ
rwm	CD, UG
rwo	PG
rwr	IN
rxd	AU
rxw	AU
ryn	JP
rys	JP
ryu	JP
rzh	YE
saa	TD
sab	PA
sac	US
sad	TZ
sae	BR
saf	GH
sag	CF
sah	RU
saj	ID
sak	GA
sam	IL, PS
san	IN
sao	ID
saq	KE
sar	BO
sas	ID
sat	BD, IN, NP
sau	ID
sav	SN
saw	ID
sax	VU
say	NG
saz	IN
sba	CM, TD
sbb	SB
sbc	PG
sbd	BF
sbe	PG
sbf	ET
sbg	ID
sbh	PG
sbi	PG
sbj	TD
sbk	TZ
sbl	PH
sbm	TZ
sbn	PK
sbo	MY
sbp	TZ
sbq	PG
sbr	ID, MY
sbs	BW, NA, ZM
sbt	ID
sbu	IN
sbw	GA
sbx	ID
sby	ZM
sbz	CF
scb	LA, VN
sce	CN
scf	PA
scg	ID
sch	IN
sci	LK
sck	IN
scl	IN, PK
scn	IT
sco	GB
scp	NP
scq	KH
scs	CA
sct	LA
scu	IN
scv	NG
scw	NG
sda	ID
sdb	IQ
sdc	IT
sde	NG
sdf	IQ
sdg	AF
sdh	IQ, IR
sdj	AO, CG
sdk	PG
sdl	SA
sdn	IT
sdo	ID, MY
sdp	IN
sdq	ID
sdr	BD
sds	TN
sdt	FR
sdu	ID
sdx	MY
sdz	NL
sea	MY
seb	CI, ML
sec	CA
sed	VN
see	CA, US
sef	CI
seg	TZ
seh	MZ
sei	MX
sej	PG
sek	CA
sel	RU
sen	BF
seo	PG
sep	BF, ML
seq	BF
ser	US
ses	ML
set	ID
seu	ID
sev	CI
sew	PG
sey	EC, PE
sez	MM
sfb	BE
sfe	PH
sfm	CN
sfs	ZA
sfw	GH
sgb	PH
sgc	KE
sgd	PH
sge	ID
sgg	CH
sgh	AF, TJ
sgi	CM
sgj	IN
sgk	CN
sgm	KE
sgp	IN
sgr	IR
sgs	LT
sgt	BT
sgu	ID
sgw	ET
sgx	SL
sgy	AF
sgz	PG
sha	NG
shb	BR, VE
shc	CD
shd	PK
she	ET
shg	BW
shh	US
shi	EH, MA
shj	SD
shk	SS
shl	IN
shm	IR
shn	MM, TH
sho	NG
shp	PE
shq	ZM
shr	CD
shs	CA
sht	US
shu	CM, NE, NG, TD
shv	OM
shw	SD
shx	CN
shy	DZ
shz	ML
sia	RU
sib	MY
sid	ET
sie	AO, ZM
sif	BF
sig	GH
sih	NC
sii	IN
sij	PG
sik	BR, SR
sil	GH
sim	PG
sin	LK
sip	IN
siq	PG
sir	NG
sis	US
siu	PG
siv	PG
siw	PG
six	PG
siy	IR
siz	EG, LY
sja	CO
sjb	ID
sjd	RU
sje	SE
sjg	TD
sjk	FI
sjl	IN
sjm	PH
sjo	CN
sjp	IN
sjr	PG
sjs	MA
sjt	RU
sju	NO, SE
sjw	US
ska	US
skb	LA, TH
skc	PG
skd	US
ske	VU
skf	BR
skg	MG
skh	ID
ski	ID
skj	NP
skm	PG
skn	PH
sko	ID
skp	MY
skq	BF
skr	IN, PK
sks	PG
skt	CD
sku	VU
skv	ID
skw	GY
skx	ID
sky	SB
skz	ID
slc	CO
sld	BF
sle	IN
slf	CH
slg	ID, MY
slh	US
sli	PL
slj	BR
slk	HU, SK
sll	PG
slm	PH
sln	US
slp	ID
slr	CN
sls	SG
slt	LA, VN
slu	ID
slv	AT, HU, IT, SI
slw	PG
slx	CD
sly	ID
slz	ID
sma	NO, SE
smb	PG
smc	PG
sme	FI, NO, SE
smf	PG
smg	PG
smh	CN
smj	NO, SE
smk	PH
sml	PH
smm	NP
smn	FI
smo	AS, WS
smp	IL, PS
smq	PG
smr	ID
sms	FI, NO, RU
smt	IN
smu	KH
smv	IN
smw	ID
smx	CD
smy	IR
smz	PG
sna	ZM, ZW
snc	PG
snd	IN, PK
sne	ID, MY
snf	SN
sng	CD
sni	PE
snj	CF
snk	GN, ML, MR, SN
snl	PH
snm	UG
snn	CO, EC
sno	US
snp	PG
snq	GA
snr	PG
sns	VU
snu	ID
snv	ID, MY
snw	GH
snx	PG
sny	PG
snz	PG
soa	TH
sob	ID
soc	CD
sod	CD
soe	CD
soh	SD
soi	NP
soj	IR
sok	TD
sol	PG
som	DJ, ET, KE, SO
soo	CD
sop	CD
soq	PG
sor	TD
sos	BF
sot	LS, ZA
sou	TH
sov	PW
sow	ID, PG
sox	CM
soy	BJ, TG
soz	TZ
spa	AD, ES, GI
spb	ID
spc	VE
spd	PG
spe	PG
spg	MY
spi	ID
spk	PG
spl	PG
spm	PG
spn	PY
spo	US
spp	ML
spq	PE
spr	ID
sps	PG
spt	IN
spu	LA
spv	IN
spy	KE
sqa	NG
sqh	NG
sqk	AL
sqm	CF
sqn	US
sqo	IR
sqq	LA
sqs	LK
sqt	YE
squ	CA
sqx	IL
sra	PG
srb	IN
src	IT
sre	ID
srf	PG
srg	PH
srh	CN, PK
sri	BR, CO
srk	MY
srl	ID
srm	SR
srn	SR
sro	IT
srp	ME, MK, RS
srq	BO
srr	GM, SN
srs	CA
srt	ID
sru	BR
srv	PH
srw	ID
srx	IN
sry	PG
srz	IR
ssb	PH
ssc	TZ
ssd	PG
sse	PH
ssf	TW
ssg	PG
ssh	AE, IR, OM
ssi	IN
ssj	PG
ssk	IN
ssl	GH
ssm	MY
ssn	KE
sso	PG
ssp	ES
ssq	ID
ssr	CH
sss	LA, TH
sst	PG
ssu	PG
ssv	VU
ssw	MZ, SZ, ZA
ssx	PG
ssy	ER, ET
ssz	PG
sta	ZM
stb	PH
std	IN
ste	ID
stf	PG
stg	VN
sth	GB, IE
sti	KH, VN
stj	BF, ML
stk	PG
stl	NL
stm	PG
stn	SB
sto	CA
stp	MX
stq	DE
str	CA, US
sts	AF
stt	VN
stu	MM
stv	ET
stw	FM
sty	RU
sua	PG
sub	AO, CD
suc	PH
sue	PG
sug	PG
sui	PG
suj	TZ
suk	TZ
sun	ID
suo	PG
suq	ET
sur	NG
sus	GN, SL
sut	NI
suv	IN
suw	TZ
suy	BR
suz	NP
sva	GE, RU
svb	PG
svc	VC
sve	ID
svk	SK
svm	IT
svs	SB
swb	YT
swc	CD
swe	AX, FI, SE
swf	CD, CF
swg	DE
swh	KE, MZ, SO, TZ
swi	CN
swj	GA
swk	MW
swl	SE
swm	PG
swn	LY
swo	BR
swp	PG
swq	CM
swr	ID
sws	ID
swt	ID
swu	ID
swv	IN
sww	VU
swx	BR
swy	TD
sxb	KE
sxe	GA
sxg	CN
sxk	US
sxm	KH, TH
sxn	ID
sxr	TW
sxs	NG
sxu	DE
sxw	BJ
sya	ID
syb	PH
syc	TR
syi	GA, GQ
syk	NG
syl	BD, IN
sym	BF
syn	IR
syo	KH
sys	TD
syw	NP
syx	GA
syy	IL
sza	MY
szb	ID, PG
szc	MY
sze	ET
szg	CD
szl	PL
szn	ID
szp	ID
szs	SB
szv	CM
szw	ID
szy	TW
taa	US
tab	RU
tac	MX
tad	ID
tae	BR
taf	BR
tag	SD
tah	PF
taj	NP
tak	NG
tal	NG
tam	IN, LK
tan	NG
tao	TW
tap	CD, ZM
taq	BF, ML
tar	MX
tas	VN
tat	RU
tau	CA, US
tav	CO
taw	PG
tax	TD
tay	TW
taz	SD
tba	BR
tbc	PG
tbd	PG
tbe	SB
tbf	PG
tbg	PG
tbh	AU
tbi	SD
tbj	PG
tbk	PH
tbl	PH
tbm	CD
tbn	CO
tbo	PG
tbp	ID
tbr	SD
tbs	PG
tbt	CD
tbu	MX
tbv	PG
tbw	PH
tbx	PG
tby	ID
tbz	BJ, TG
tca	BR, CO, PE
tcb	US
tcc	TZ
tcd	GH
tce	CA
tcf	MX
tcg	ID
tch	TC
tci	PG
tck	GA
tcl	MM
tcm	ID
tcn	NP
tco	MM
tcp	MM
tcq	ID
tcs	AU
tct	CN
tcu	MX
tcw	MX
tcx	IN
tcy	IN
tcz	IN, MM
tda	NE
tdb	IN
tdc	CO
tdd	CN, MM
tde	ML
tdf	LA
tdg	NP
tdh	NP
tdi	ID
tdj	ID
tdk	NG
tdl	NG
tdm	GY
tdn	ID
tdo	NG
tdq	NG
tdr	VN
tds	ID
tdt	TL
tdv	NG
tdx	MG
tdy	PH
tea	MY
teb	EC
tec	KE
ted	CI
tee	MX
tef	IN
teg	CG, GA
teh	AR
tei	PG
tek	CD, CG
tel	IN
tem	SL
ten	CO
teo	KE, UG
tep	MX
teq	SD
ter	BR
tes	ID
tet	ID, TL
teu	UG
tev	ID
tew	US
tex	SS
tey	SD
tez	NE
tfi	BJ
tfn	US
tfo	ID
tfr	PA
tft	ID
tga	KE
tgb	MY
tgc	PG
tgd	NG
tge	NP
tgf	BT
tgh	TT
tgi	PG
tgj	IN
tgk	TJ, UZ
tgl	PH
tgn	PH
tgo	PG
tgp	VU
tgq	MY
tgr	LA
tgs	VU
tgt	PH
tgu	PG
tgv	BR
tgw	CI
tgx	CA
tgy	SS
tgz	AU
tha	KH, TH
thd	AU
the	IN, NP
thf	NP
thh	MX
thi	LA
thk	KE
thl	IN, NP
thm	TH
thn	IN
thp	CA
thq	NP
thr	IN, NP
ths	NP
tht	CA
thu	SS
thv	DZ, LY, NE
thy	NG
thz	NE
tia	DZ
tic	SD
tif	PG
tig	ER, SD
tih	MY
tii	CD
tij	NP
tik	CM
til	US
tim	PG
tin	RU
tio	PG
tip	ID
tiq	BF
tir	ER, ET
tis	PH
tit	CO
tiu	PH
tiv	CM, NG
tiw	AU
tix	US
tiy	PH
tiz	CN
tja	LR
tjg	ID
tji	CN
tjj	AU
tjl	MM
tjm	US
tjn	CI
tjo	DZ
tjp	AU
tjs	CN
tju	AU
tjw	AU
tka	BR
tkb	IN
tkd	TL
tke	MZ
tkf	BR
tkg	MG
tkl	TK
tkm	US
tkn	JP
tkp	SB
tkq	NG
tkr	AZ, RU
tks	IR
tkt	IN, NP
tku	MX
tkv	PG
tkw	SB
tkx	ID
tkz	VN
tla	MX
tlb	ID
tlc	MX
tld	ID
tlf	PG
tlg	ID
tli	CA, US
tlj	CD, UG
tlk	ID
tll	CD
tlm	VU
tln	ID
tlo	SD
tlp	MX
tlq	LA, MM
tlr	SB
tls	VU
tlt	ID
tlu	ID
tlv	ID
tlx	PG
tly	AZ, IR
tma	SD, TD
tmb	VU
tmc	TD
tmd	PG
tme	BR
tmf	PY
tmg	ID
tmi	VU
tmj	ID
tml	ID
tmm	VN
tmn	ID
tmo	MY
tmq	PG
tmr	IL
tms	SD
tmt	VU
tmu	ID
tmv	CD
tmw	MY
tmy	PG
tmz	VE
tna	BO
tnb	CO
tnc	CO
tnd	CO
tng	TD
tnh	PG
tni	ID
tnk	VU
tnl	VU
tnm	ID
tnn	VU
tno	BO
tnp	VU
tnq	PR
tnr	SN
tns	PG
tnt	ID
tnu	LA
tnv	BD
tnw	ID
tnx	SB
tny	TZ
tnz	MY, TH
tob	AR, PY
toc	MX
tod	GN
tof	PG
tog	MW
toh	MZ
toi	ZM, ZW
toj	MX
tol	US
tom	ID
ton	TO
too	MX
top	MX
toq	SS
tor	CD, CF
tos	MX
tou	VN
tov	IR
tow	US
tox	PW
toy	ID
toz	CM
tpa	PG
tpc	MX
tpe	BD
tpf	ID
tpg	ID
tpi	PG
tpj	AR, BO, PY
tpk	BR
tpl	MX
tpm	GH
tpn	BR
tpo	LA, VN
tpp	MX
tpq	IN
tpr	BR
tpt	MX
tpu	KH
tpv	MP
tpx	MX
tpy	BR
tpz	PG
tqb	BR
tql	VU
tqm	PG
tqn	US
tqo	PG
tqp	PG
tqq	SO
tqr	SD
tqt	MX
tqu	SB
tqw	US
tra	AF
trb	PG
trc	MX
trd	IN
tre	ID
trf	TT
trg	IL
trh	PG
tri	BR, SR
trj	TD
trl	GB
trm	AF
trn	BO
tro	IN
trp	BD, IN
trq	MX
trr	PE
trs	MX
trt	ID
tru	SY, TR
true	NG
trv	TW
trw	PK
trx	MY
try	IN
trz	BR
tsa	CG, GA
tsb	ET
tsc	MZ, ZW
tsd	GR
tse	TN
tsg	PH
tsh	CM
tsi	CA, US
tsj	BT, CN, IN
tsk	CN
tsl	VN
tsm	TR
tsn	BW, NA, ZA
tso	MZ, ZA
tsp	BF
tsq	TH
tsr	VU
tss	TW
tst	ML
tsu	TW
tsv	GA
tsw	NG
tsx	PG
tsy	ML
tsz	MX
tta	CA
ttb	NG
ttc	GT, MX
ttd	PG
tte	PG
ttf	CM
ttg	BN
tth	LA, VN
tti	ID
ttj	UG
ttk	CO
ttl	ZM
ttm	CA
ttn	ID
tto	LA
ttp	ID
ttq	ML, NE
ttr	NG
tts	TH
ttt	AZ, RU
ttu	PG
ttv	PG
ttw	MY
tty	ID
ttz	NP
tua	PG
tub	US
tuc	PG
tud	BR
tue	BR, CO
tuf	CO
tug	TD
tuh	PG
tui	CM, TD
tuj	ID
tuk	AF, IR, TM
tul	NG
tum	MW, ZM
tun	US
tuo	BR, CO
tuq	LY, NE, TD
tur	BG, CY, GR, TR
tus	CA, US
tuu	US
tuv	KE
tux	BR
tuy	KE
tuz	BF
tva	SB
tvd	NG
tve	ID
tvi	NG
tvk	VU
tvl	TV
tvm	ID
tvn	MM
tvo	ID
tvs	KE
tvt	IN
tvu	CM
tvw	ID
tvx	TW
tvy	TL
twa	US
twb	PH
twc	NG
twd	NL
twe	ID
twf	US
twg	ID
twh	CN, LA, VN
twl	MZ
twm	CN, IN
twn	CM
two	BW
twp	PG
twq	NE
twr	MX
twt	BR
twu	ID
tww	PG
twx	MZ
twy	ID
txa	MY
txc	CA, US
txe	ID
txi	BR
txj	NG
txm	ID
txn	ID
txo	IN
txq	ID
txs	ID
txt	ID
txu	BR
txx	MY
txy	MG
tya	PG
tye	BJ, NG
tyh	LA, VN
tyi	CG
tyj	LA, VN
tyl	VN
tyn	ID
typ	AU
tyr	LA, VN
tys	VN
tyt	VN
tyu	BW
tyv	MN, RU
tyx	CG
tyy	NG
tyz	VN
tza	TZ
tzh	MX
tzj	GT
tzm	MA
tzn	ID
tzo	MX
tzx	PG
uam	BR
uan	LA
uar	PG
uba	NG
ubi	TD
ubl	PH
ubr	PG
ubu	PG
uby	TR
uda	NG
ude	RU
udg	IN
udi	AZ
udj	ID
udl	CM
udm	RU
udu	SD, SS
ues	ID
ufi	PG
ugb	AU
uge	SB
ugh	RU
ugn	UG
ugo	TH
ugy	UY
uha	NG
uhn	ID
uig	CN, KZ, MN
uis	PG
uiv	CM, NG
uji	NG
uka	ID
ukg	PG
ukh	CF
uki	IN
ukk	CN, MM
ukl	UA
ukp	NG
ukq	NG
ukr	RO, SK, UA
uks	BR
uku	NG
ukv	UG
ukw	NG
uky	AU
ula	NG
ulb	NG
ulc	RU
ule	AR
ulf	ID
uli	FM
ulk	AU
ull	IN
ulm	ID
uln	PG
ulu	ID
ulw	NI
uly	NG
uma	US
umb	AO
umd	AU
umg	AU
umi	MY
umm	NG
umn	MM
umo	BR
ump	AU
umr	AU
ums	ID
umu	CA, US
una	PG
une	NG
ung	AU
uni	PG
unk	BR
unm	US
unn	AU
unr	IN
unu	PG
unx	IN
unz	ID
uon	TW
upi	PG
upv	VU
ura	PE
urb	BR
urc	AU
urd	IN, PK
ure	BO
urf	AU
urg	PG
urh	NG
uri	PG
urk	TH
url	IN
urm	PG
urn	ID
uro	PG
urp	BR
urr	VU
urt	PG
uru	BR
urv	PG
urw	PG
urx	PG
ury	ID
urz	BR
usa	PG
ush	PK
usi	BD
usk	CM, NG
usp	GT
uss	NG
usu	PG
uta	NG
ute	US
uth	NG
utp	SB
utr	NG
utu	PG
uum	GE
uur	VU
uuu	CN
uve	NC
uvh	PG
uvl	PG
uwa	AU
uya	NG
uzn	TJ, TM, UZ
uzs	AF
vaa	IN
vae	CF
vaf	IR
vag	GH
vah	IN
vai	LR, SL
vaj	AO, NA
val	PG
vam	PG
van	PG
vao	VU
vap	IN
var	MX
vas	IN
vau	CD
vav	IN
vay	NP
vbb	ID
vbk	PH
vec	IT
ved	LK
vel	NL
vem	CM, NG
ven	ZA, ZW
veo	US
vep	RU
ver	CM, NG
vgr	PK
vgt	BE
vic	VG, VI
vid	TZ
vie	CN, VN
vif	AO, CG, GA
vig	BF
vil	AR
vis	IN
vit	NG
viv	PG
vjk	IN, NP
vka	AU
vkj	TD
vkk	ID
vkl	ID
vkm	BR
vkn	NG
vko	ID
vkp	IN
vkt	ID
vku	AU
vkz	NG
vlp	VU
vls	BE, FR, NL
vma	AU
vmb	AU
vmc	MX
vmd	IN
vme	ID
vmf	DE
vmg	PG
vmh	IR
vmi	AU
vmj	MX
vmk	MZ
vml	AU
vmm	MX
vmp	MX
vmq	MX
vmr	MZ
vms	ID
vmu	AU
vmv	US
vmw	MZ
vmx	MX
vmy	MX
vmz	MX
vnk	SB
vnm	VU
vnp	VU
vor	NG
vot	RU
vra	VU
vro	EE, LV, RU
vrs	SB
vrt	VU
vsi	MD
vsl	VE
vsv	ES
vto	ID
vum	GA
vun	TZ
vut	CM, NG
vwa	CN
waa	US
wab	PG
wac	US
wad	ID
wae	AT, CH, IT, LI
waf	BR
wag	PG
wah	ID
wai	ID
waj	PG
wal	ET
wam	US
wan	CI
wao	US
wap	BR, GY
waq	AU
war	PH
was	US
wat	PG
wau	BR
wav	NG
waw	BR, GY
wax	PG
way	BR, GF, SR
waz	PG
wba	GY, VE
wbb	ID
wbe	ID
wbf	BF
wbh	TZ
wbi	TZ
wbj	TZ
wbk	AF
wbl	AF, PK, TJ
wbm	CN
wbp	AU
wbq	IN
wbr	IN
wbs	IN
wbt	AU
wbv	AU
wbw	ID
wca	BR
wci	BJ, TG
wdd	GA
wdg	PG
wdj	AU
wdk	AU
wdt	CA
wdu	AU
wdy	AU
wea	MM
wec	CI
wed	PG
weg	AU
weh	CM
wei	PG
wem	BJ
weo	ID
wep	DE
wer	PG
wes	CM
wet	ID
weu	MM
wew	ID
wfg	ID
wga	AU
wgb	PG
wgg	AU
wgi	PG
wgo	ID
wgu	AU
wgy	AU
wha	ID
whg	PG
whk	ID
whu	ID
wib	BF
wic	US
wie	AU
wif	AU
wig	AU
wih	AU
wii	PG
wij	AU
wik	AU
wil	AU
wim	AU
win	US
wir	BR
wiu	PG
wiv	PG
wiy	US
wja	NG
wji	NG
wka	TZ
wkb	IN
wkd	ID
wkl	IN
wkr	AU
wku	IN
wkw	AU
wky	AU
wla	PG
wlc	KM
wle	ET
wlg	AU
wlh	ID, TL
wli	ID
wlk	US
wll	SD
wln	BE
wlo	ID
wlr	VU
wls	WF
wlu	AU
wlv	AR
wlw	ID
wlx	GH
wmb	AU
wmc	PG
wmd	BR
wme	NP
wmg	CN
wmh	TL
wmi	AU
wmm	ID
wmn	NC
wmo	PG
wms	ID
wmt	AU
wmw	MZ
wmx	PG
wnb	PG
wnc	PG
wnd	AU
wne	PK
wng	ID
wni	KM
wnk	ID
wnm	AU
wnn	AU
wno	ID
wnp	PG
wnu	PG
wnw	US
wny	AU
woa	AU
wob	CI
woc	PG
wod	ID
woe	FM
wof	GM
wog	PG
woi	ID
wok	CM
wol	MR, SN
wom	NG
won	CD
woo	ID
wor	ID
wos	PG
wow	ID
woy	ET
wpc	VE
wrb	AU
wrg	AU
wrh	AU
wri	AU
wrk	AU
wrl	AU
wrm	AU
wrn	SD
wro	AU
wrp	ID
wrr	AU
wrs	ID, PG
wru	ID
wrv	PG
wrw	AU
wrx	ID
wry	IN
wrz	AU
wsa	ID
wsg	IN
wsi	VU
wsk	PG
wsr	PG
wss	GH
wsu	BR
wsv	AF
wtb	TZ
wtf	PG
wth	AU
wti	ET, SD
wtk	PG
wtm	IN
wtw	ID
wua	AU
wub	AU
wud	TG
wuh	CN
wul	ID
wum	CG, GA
wun	TZ
wut	PG
wuu	CN
wuv	PG
wux	AU
wuy	ID
wwa	BJ
wwb	AU
wwo	VU
wwr	AU
www	CM
wxa	CN
wxw	AU
wyb	AU
wyi	AU
wym	PL
wyn	US
wyr	BR
wyy	FJ
xab	NG
xac	IN
xad	US
xai	BR
xaj	BR
xak	BR, VE
xal	RU
xam	ZA
xan	ET
xao	VN
xap	US
xar	PG
xas	RU
xat	BR
xau	ID
xav	BR
xaw	US
xay	ID
xbb	AU
xbd	AU
xbe	AU
xbg	AU
xbi	PG
xbj	AU
xbn	MY
xbp	AU
xbr	ID
xbw	BR
xby	AU
xch	US
xcm	MX
xcn	MX, US
xcv	RU
xcw	MX, US
xcy	US
xda	AU
xdk	AU
xdo	AO
xdq	RU
xdy	ID
xed	CM, NG
xeg	ZA
xel	SD
xem	ID
xer	BR
xes	PG
xet	BR
xeu	PG
xgb	CI
xgd	AU
xgf	US
xgg	AU
xgi	AU
xgm	AU
xgr	MX, US
xgu	AU
xgw	AU
xhe	PK
xho	LS, ZA
xhv	LA, VN
xii	ZA
xin	GT
xir	BR
xis	IN
xiy	BR
xjb	AU
xjt	AU
xka	PK
xkb	BJ, TG
xkc	IR
xkd	ID
xke	ID
xkf	BT
xkg	ML
xki	KE
xkj	IR
xkk	KH
xkl	ID, MY
xkn	ID
xko	LA
xkp	IR
xkq	ID
xkr	BR
xks	ID
xkt	GH
xku	CG
xkv	BW
xkw	ID
xkx	PG
xky	ID, MY
xkz	BT
xla	PG
xlb	US
xlo	US
xma	SO
xmb	CM
xmc	MZ
xmd	CM
xmf	GE
xmg	CM
xmh	AU
xmj	CM, TD
xml	MY
xmm	ID
xmo	BR
xmp	AU
xmq	AU
xms	MA
xmt	ID
xmu	AU
xmv	MG
xmw	MG
xmx	ID
xmy	AU
xmz	ID
xnb	TW
xnh	CN
xni	AU
xnj	TZ
xnk	AU
xnm	AU
xnn	PH
xnq	MZ
xnr	IN
xns	IN
xnt	US
xnu	AU
xny	AU
xnz	EG
xoc	NG
xod	ID
xog	UG
xoi	PG
xok	BR
xom	ET, SD, SS
xon	GH, TG
xoo	BR
xop	PG
xor	BR
xow	PG
xpa	AU
xpb	AU
xpd	AU
xpe	LR
xpf	AU
xph	AU
xpj	AU
xpk	BR
xpl	AU
xpm	RU
xpn	BR
xpo	MX
xpq	US
xpt	AU
xpv	AU
xpw	AU
xpx	AU
xpz	AU
xra	BR
xrb	BF
xrd	AU
xre	BR
xrg	AU
xri	BR
xrn	RU
xrt	US
xru	AU
xrw	PG
xsb	PH
xse	ID
xsh	NG
xsi	PG
xsj	TZ
xsl	CA
xsm	BF, GH
xsn	NG
xso	MX
xsp	PG
xsq	MZ
xsr	CN, IN, NP
xsu	BR, VE
xsv	BY, LT, PL
xsy	TW
xta	MX
xtb	MX
xtc	SD
xtd	MX
xte	ID
xth	AU
xti	MX
xtj	MX
xtl	MX
xtm	MX
xtn	MX
xtp	MX
xts	MX
xtt	MX
xtu	MX
xtv	AU
xtw	BR
xty	MX
xua	IN
xub	IN
xud	AU
xug	JP
xuj	IN
xul	AU
xun	AU
xuo	CM, TD
xup	US
xut	AU
xuu	AO, BW, NA
xvi	AF, PK
xwa	BR
xwc	US
xwd	AU
xwe	BJ
xwg	ET
xwj	AU
xwk	AU
xwl	BJ, TG
xwr	ID
xwt	AU
xww	AU
xxb	GH
xxk	ID
xxm	AU
xxr	BR
xxt	ID
xya	AU
xyb	AU
xyj	AU
xyk	AU
xyl	BR
xyt	AU
xyy	AU
xzm	LT, LV
yaa	BO, BR, PE
yab	BR
yac	ID
yad	CO, PE
yae	VE
yaf	AO, CD
yag	AR, CL
yah	TJ
yai	TJ
yaj	CF
yak	US
yal	GN, ML, SL, SN
yam	CM, NG
yan	HN, NI
yao	MW, MZ
yap	FM
yaq	MX
yar	VE
yas	CM
yat	CM
yau	VE
yav	CM
yaw	BR
yax	AO, ZM
yay	NG
yaz	NG
yba	NG
ybb	CM
ybe	CN
ybh	IN, NP
ybi	NP
ybj	NG
ybk	CN
ybl	CM, NG
ybm	PG
ybn	BR
ybo	PG
ybx	PG
yby	PG
ych	CN
ycl	CN
ycn	CO
ycp	LA
ycr	TW
yda	AU
ydd	UA
yde	PG
ydg	PK
ydk	PG
yea	IN
yec	DE
yee	PG
yei	CM
yej	GR, IL
yer	NG
yet	ID
yeu	IN
yev	PG
yey	BW, NA
yga	AU
ygi	AU
ygl	PG
ygm	PG
ygp	CN
ygr	PG
ygs	AU
ygu	AU
ygw	PG
yha	CN
yhd	IL
yhl	CN
yhs	AU
yia	AU
yif	CN
yig	CN
yih	DE
yii	AU
yij	AU
yik	CN
yil	AU
yim	IN
yin	MM
yip	CN
yiq	CN
yir	ID
yis	PG
yit	CN
yiu	CN
yiv	CN
yix	CN
yiz	CN
yka	PH
ykg	RU
ykh	CN, MN, RU
yki	ID
ykk	PG
ykl	CN
ykm	PG
ykn	CN
yko	CM, GQ
ykr	PG
ykt	CN
yku	CN
yky	CF
yla	PG
ylb	PG
yle	PG
ylg	PG
yli	ID
yll	PG
ylm	CN
yln	CN
ylo	CN
ylr	AU
ylu	PG
yly	NC
ymb	PG
ymc	CN
ymd	CN
yme	PE
ymg	CD
ymh	CN
ymi	CN
ymk	MZ, TZ
yml	PG
ymm	SO
ymn	ID
ymo	PG
ymp	PG
ymq	CN
ymr	IN
ymx	CN
ymz	CN
yna	CN
ynd	AU
yne	CN
yng	CD
ynk	RU
ynl	PG
ynn	US
yno	TH
ynq	NG
yns	CD
ynu	CO
yob	PG
yog	PH
yoi	JP
yok	US
yol	IE
yom	AO, CD, CG
yon	PG
yor	NG
yot	NG
yox	JP
yoy	LA, TH
ypa	CN
ypb	CN
ypg	CN
yph	CN
ypm	CN
ypn	CN
ypo	CN
ypp	CN
ypz	CN
yra	PG
yrb	PG
yre	CI
yrk	RU
yrl	BR, CO, VE
yrm	AU
yrn	CN
yro	BR
yrs	ID
yrw	PG
yry	AU
ysc	HU
ysd	CN
ysg	CN
ysl	BA, ME, MK, RS, SI
ysm	MM
ysn	CN
yso	CN
ysp	CN
ysr	RU
yss	PG
ysy	CN
yta	CN
ytl	CN
ytp	CN
ytw	PG
yty	AU
yua	BZ, MX
yub	AU
yuc	US
yud	IL
yue	CN, HK, MO
yuf	US
yug	RU
yui	BR, CO
yuj	PG
yuk	US
yul	CF, SD
yum	US
yun	NG
yup	CO, VE
yuq	BO
yur	US
yut	PG
yuw	PG
yux	RU
yuy	CN
yuz	BO
yva	ID
yvt	VE
ywa	PG
ywg	AU
ywl	CN
ywn	BR
ywq	CN
ywr	AU
ywt	CN
ywu	CN
yww	AU
yxa	AU
yxg	AU
yxl	AU
yxm	AU
yxu	AU
yxy	AU
yyr	AU
yyu	PG
yyz	CN
yzg	CN
yzk	CN
zaa	MX
zab	MX
zac	MX
zad	MX
zae	MX
zaf	MX
zag	SD, TD
zah	NG
zai	MX
zaj	TZ
zak	TZ
zal	CN
zam	MX
zao	MX
zaq	MX
zar	MX
zas	MX
zat	MX
zau	IN
zav	MX
zaw	MX
zax	MX
zay	ET
zaz	NG
zbc	MY
zbe	MY
zbt	ID
zbu	NG
zbw	MY
zca	MX
zcd	MX
zch	CN
zdj	KM
zea	NL
zeg	PG
zeh	CN
zem	NG
zen	MR
zga	TZ
zgb	CN
zgh	MA
zgm	CN
zgn	CN
zgr	PG
zhb	CN
zhd	CN
zhi	NG
zhn	CN
zhw	CM
zia	PG
zib	ZW
zik	PG
zil	GN
zim	TD
zin	TZ
ziw	TZ
ziz	CM, NG
zka	ID
zkd	MM
zkk	US
zkn	MM
zko	RU
zkp	BR
zkr	CN
zku	AU
zkv	LV
zla	CD
zlj	CN
zlm	ID, MY
zln	CN
zlq	CN
zlu	NG
zma	AU
zmb	CD
zmc	AU
zmd	AU
zme	AU
zmf	CD
zmg	AU
zmh	PG
zmi	MY
zmj	AU
zmk	AU
zml	AU
zmm	AU
zmn	CG, GA
zmo	SD
zmp	CD
zmq	CD
zmr	AU
zms	CD
zmt	AU
zmu	AU
zmv	AU
zmw	CD
zmx	CG
zmy	AU
zmz	CD, CG
zna	TD
zne	CD, CF, SS
zng	CN, VN
znk	AU
zns	NG
zoc	MX
zoh	MX
zom	IN, MM
zoo	MX
zoq	MX
zor	MX
zos	MX
zpa	MX
zpb	MX
zpc	MX
zpd	MX
zpe	MX
zpf	MX
zpg	MX
zph	MX
zpi	MX
zpj	MX
zpk	MX
zpl	MX
zpm	MX
zpn	MX
zpo	MX
zpp	MX
zpq	MX
zpr	MX
zps	MX
zpt	MX
zpu	MX
zpv	MX
zpw	MX
zpx	MX
zpy	MX
zpz	MX
zqe	CN
zrg	IN
zrn	TD
zro	EC
zrs	ID
zsa	PG
zsl	ZM
zsm	MY
zsr	MX
zsu	PG
zte	MX
ztg	MX
ztl	MX
ztm	MX
ztn	MX
ztp	MX
ztq	MX
zts	MX
ztt	MX
ztu	MX
ztx	MX
zty	MX
zuh	PG
zul	LS, MZ, ZA
zum	IR, OM
zun	US
zuy	CM
zwa	ET
zyb	CN
zyg	CN
zyj	CN
zyn	CN
zyp	IN, MM
zzj	CN